love	愛
instagood	instagood
photooftheday	その日の写真
fashion	ファッション
beautiful	綺麗な
happy	ハッピー
cute	可愛い
tbt	tbt
like4like	like4like
followme	フォローしてください
picoftheday	ピコフデーデー
follow	フォローする
me	私
selfie	セルフ
summer	夏
art	アート
instadaily	瞬間
friends	友達
repost	再ポスト
nature	自然
girl	女の子
fun	楽しい
style	スタイル
smile	スマイル
food	フード
instalike	インスタントライク
family	家族
travel	旅行
likeforlike	likeforlike
fitness	フィットネス
follow4follow	follow4フォロー
igers	イグアス
tagsforlikes	同類のタグ
nofilter	nofilter
life	生活
beauty	美しさ
amazing	素晴らしい
instagram	インスタグラム
photography	写真
photo	写真
vscocam	vscocam
sun	太陽
music	音楽
followforfollow	フォローフォロー
beach	ビーチ
ootd	おっと
bestoftheday	最善の選択肢
sunset	日没
dog	犬
sky	空
vsco	vsco
l4l	14l
makeup	化粧
foodporn	foodporn
f4f	f4f
hair	ヘア
pretty	かなり
cat	ネコ
model	モデル
swag	みやげ品
motivation	動機
girls	女の子
party	パーティー
baby	赤ちゃん
cool	クール
gym	ジム
lol	笑
design	設計
instapic	インスタティック
funny	面白い
healthy	健康
christmas	クリスマス
night	夜
lifestyle	ライフスタイル
yummy	おいしい
flowers	フラワーズ
tflers	tflers
hot	ホット
handmade	手作り
instafood	魚介類
wedding	結婚式
fit	フィット
black	黒
pink	ピンク
blue	青
workout	いい結果になる
work	作業
blackandwhite	黒と白
drawing	お絵かき
inspiration	インスピレーション
holiday	休日
home	自宅
london	ロンドン
nyc	ニューヨーク
sea	海
instacool	インスパイア
winter	冬
goodmorning	おはようございます
blessed	祝福された
dogsofinstagram	dogsofinstagram
sweet	甘い
red	赤
iphoneonly	iphoneonly
happiness	幸福
throwback	後退
birthday	お誕生日
followback	フォローバック
instafollow	instafollow
instalove	インスタント
weekend	週末
coffee	コーヒー
tattoo	入れ墨
puppy	子犬
my	じぶんの
clouds	雲
fitfam	フィットファム
artist	アーティスト
morning	朝
green	緑
webstagram	Webstagram
awesome	驚くばかり
foodie	食通
shopping	ショッピング
look	見える
new	新しい
tweegram	tweegram
nails	爪
paris	パリ
iphonesia	イフォニヤ
nice	いい
sunday	日曜日
dinner	ディナー
landscape	風景
japan	日本
italy	イタリア
photographer	写真家
likes	好きな人
relax	リラックス
dress	ドレス
igdaily	igdaily
instafashion	インスパイアドファッション
delicious	おいしい
spring	春
white	白
catsofinstagram	catsofinstagram
vacation	休暇
instasize	instasize
architecture	建築
boy	男の子
eyes	目
trip	旅行
health	健康
shoes	靴
instago	インサゴ
latepost	ラストポスト
breakfast	朝ごはん
bodybuilding	ボディービルディング
yum	ヤム
loveit	大好きです
vintage	ビンテージ
day	日
nike	ナイキ
daily	毎日
outfit	服装
moda	モダ
snow	雪
good	良い
likeforfollow	likeforfollow
halloween	ハロウィーン
wcw	wcw
dubai	ドバイ
wanderlust	さまよう
training	トレーニング
indonesia	インドネシア
instagramers	インストラクター
newyork	ニューヨーク
luxury	贅沢
tb	tb
all_shots	すべてのショット
instagramhub	instagramhub
illustration	図
lunch	ランチ
picture	画像
usa	アメリカ合衆国
memories	思い出
sketch	スケッチ
instaphoto	インスタント写真
anime	アニメ
cats	猫
best	ベスト
travelgram	旅行記
flower	花
live	ライブ
dogs	犬
goodnight	おやすみ
colorful	カラフル
2017	2017年
chocolate	チョコレート
fashionblogger	ファッションブロガー
pet	ペット
autumn	秋
fashionista	ファッショニスタ
peace	平和
adventure	冒険
amor	アモール
onedirection	ひとつの方向
dance	ダンス
city	シティ
bestfriend	親友
insta	インスタ
happybirthday	お誕生日おめでとうございます
cake	ケーキ
friday	金曜日
color	色
portrait	ポートレート
bored	退屈な
chanel	シャネル
pic	写真
goodtimes	おはようございます
vegan	完全な
instatravel	instatravel
water	水
photoshoot	写真撮影
view	見る
adorable	愛らしい
canon	キヤノン
istanbul	イスタンブール
kids	子供たち
fitspo	ぴったり
saturday	土曜日
likesforlikes	好きなもの
california	カリフォルニア
gay	同性愛者
blogger	ブロガー
bff	bff
tumblr	タンブラー
quotes	引用符
lovely	美しい
goals	ゴール
mylove	私の愛
beer	ビール
eatclean	食べる
perfect	完璧な
friend	友人
bestfriends	親友
blonde	ブロンド
light	光
painting	ペインティング
sunshine	日光
quote	見積もり
mcm	mcm
france	フランス
loveher	彼女を愛している
bomdia	BOM dia
thailand	タイ
homemade	自家製
instadog	instadog
artwork	アートワーク
miami	マイアミ
2016	2016年
disney	ディズニー
1	1
shoutout	大声で叫ぶ
20likes	20かかりつけ
fresh	新鮮な
yoga	ヨガ
sunrise	日の出
top	上
nikon	ニコン
boanoite	ボアノイト
street	通り
sport	スポーツ
diet	ダイエット
sister	シスター
holidays	休日
instamoment	インストラクター
fall	秋
jewelry	宝石
mood	気分
forever	永遠に
car	車
gucci	グッチ
latergram	後のグラム
colors	色
ink	インク
sale	販売
truth	真実
ocean	海洋
uae	ウエ
hiphop	ヒップホップ
onlineshop	オンラインショップ
tree	木
crazy	狂った
i	私
familia	ファミリア
likeback	バックのような
kpop	kpop
regrann	再確認
dogstagram	ドッグスグラム
traveling	旅行
babygirl	ベビーガール
streetstyle	ストリートスタイル
sisters	姉妹
explore	探検する
la	ラ
stylish	スタイリッシュ
mountains	山々
natural	ナチュラル
weightloss	減量
kuwait	クウェート
throwbackthursday	スローバック日
goodvibes	いい感じ
nailart	ネイルアート
animal	動物
football	フットボール
makeupartist	makeupartist
dior	ディオール
adidas	アディダス
jj	jj
australia	オーストラリア
lfl	lfl
gorgeous	ゴージャスな
running	ランニング
draw	ドロー
interiordesign	インテリア・デザイン
bts	BTS
animals	動物
lovehim	彼が好き
tattoos	入れ墨
friendship	友情
mexico	メキシコ
sunny	晴れた
picstitch	塗膜
losangeles	ロサンゼルス
healthyfood	健康食品
loveyou	あなたを愛してます
strong	強い
kitty	子猫
2015	2015年
prada	プラダ
world	世界
harrystyles	ハルツィルズ
mua	ムア
school	学校
creative	創造的な
jakarta	ジャカルタ
russia	ロシア
spain	スペイン
venezuela	ベネズエラ
pets	ペット
like4follow	like4follow
abs	abs
hermes	ヘルメス
boyfriend	ボーイフレンド
the	その
mylife	私の人生
polishgirl	ポーランド女性
cleaneating	洗浄する
muscle	筋
germany	ドイツ
body	体
gold	ゴールド
enjoy	楽しい
wine	ワイン
trees	木
today	今日
barcelona	バルセロナ
dessert	デザート
potd	ポット
streetphotography	ストリートフォトグラフィー
time	時間
couple	カップル
sundayfunday	日曜日
roadtrip	ロードトリップ
instacollage	植え付け
brasil	ブラジル
cold	コールド
bali	バリ
crossfit	クロスフィット
meme	ミーム
streetart	ストリートアート
gopro	ゴプロ
moscow	モスクワ
красота	красота
instafit	instafit
gymlife	ジムライフ
handsome	ハンサム
monday	月曜
hairstyle	ヘアスタイル
canada	カナダ
iphone	iPhone
florida	フロリダ
exercise	運動
fitnessmotivation	フィットネス運動
hijab	ヒジャーブ
merrychristmas	メリークリスマス
foodstagram	食べ物
justinbieber	ジャスティン・ビーバー
likes4likes	likes4likes
catstagram	catstagram
memes	ミームズ
cafe	カフェ
turkey	七面鳥
uk	イギリス
chicago	シカゴ
babyboy	男の赤ちゃん
passion	情熱
garden	庭園
bajumurah	バジュムラ
kiss	キッス
diy	ディー
iloveyou	わたしは、あなたを愛しています
petstagram	ペトログラフ
cardio	心臓
foodgasm	フードガム
cutie	キューティー
a	a
outdoors	屋外
amigos	アミーゴス
naturelovers	自然の流れ
travelling	旅行
video	ビデオ
2	2
boys	男の子
followher	追従者
gift	贈り物
travelphotography	旅行写真
instaart	インスタント
heart	ハート
starbucks	スターバックス
you	君は
niallhoran	ナイロホラン
summertime	夏時間
instachile	絆創膏
bride	花嫁
familytime	家族の時間
feliz	フェリズ
pizza	ピザ
brother	兄
run	走る
decor	装飾
tokyo	東京
lake	湖
success	成功
yellow	黄
hiking	ハイキング
eat	食べる
shop	ショップ
graffiti	落書き
drinks	飲む
interior	インテリア
chill	冷やす
bahrain	バーレーン
icecream	アイスクリーム
rain	雨
rock	岩
italia	イタリア
mom	ママ
train	列車
cars	車
inlove	恋愛中
kitten	子猫
accessories	アクセサリー
film	膜
lovethem	彼らを愛する
fendi	フェンディ
vegas	ベガス
tired	疲れた
tgif	tgif
youtube	youtube
designer	デザイナー
man	おとこ
fff	fff
bikini	ビキニ
princess	王女
face	面
beard	ひげ
exo	エキスポ
happynewyear	明けましておめでとうございます
korea	韓国
followers	フォロワー
lmao	イマ
louisvuitton	ルイヴィトン
book	本
sunnyday	日の出
europe	ヨーロッパ
ksa	KSA
nail	ネイル
nutrition	栄養
dream	夢
yolo	イエロー
louistomlinson	ルイ・トムリンソン
givenchy	与えられた
tasty	おいしい
lights	ライト
kawaii	かわいい
god	神
money	お金
instacat	インスタント
cousins	いとこ
orange	オレンジ
toronto	トロント
weather	天気
fitnessmodel	フィットネスモデル
olshop	オルショップ
business	ビジネス
comment	コメント
2014	2014
starwars	スターウォーズ
420	420
berlin	ベルリン
россия	россия
лето	лето
lips	唇
movie	映画
instastyle	instastyle
with	〜と
india	インド
fitnessaddict	フィットネスアクト
classic	クラシック
naturephotography	自然写真
bmw	BMW
entrepreneur	起業家
puppylove	初恋
thankful	感謝している
goodday	良い一日
blog	ブログ
organic	オーガニック
people	人
teamo	チーム
paradise	パラダイス
valentino	ヴァレンティーノ
pictureoftheday	画像の変更
men	男性
styles	スタイル
instagay	インスタガイ
liampayne	リアム・ペイン
free	無料
celine	セリーヌ
manga	マンガ
focus	フォーカス
TRUE	真
mensfashion	メンズファッション
bandung	バンドン
homedecor	室内装飾
house	家
dope	ドープ
photos	写真
lasvegas	ラスベガス
old	古い
and	そして
photogrid	フォトグリッド
bag	バッグ
haha	ハハ
freedom	自由
burberry	バーバリー
dj	DJ
cartier	カルティエ
in	に
amo	アモ
malaysia	マレーシア
outfitoftheday	今日の衣装
concert	コンサート
urban	都市
arte	アルテ
sayajual	イマージョン
thankyou	ありがとうございました
mybaby	マイベイビー
instahub	インストハブ
america	アメリカ
getfit	getfit
longhair	長い髪
brunette	ブルネット
purple	紫の
follower	フォロワー
wow	ワオ
moment	瞬間
newyear	新年
bike	自転車
mydubai	ミュードバイ
zaynmalik	zaynmalik
brazil	ブラジル
doglover	愛犬家
madrid	マドリード
vscogood	vscogood
healthylifestyle	健康的な生活様式
zara	ザラ
sol	ソル
chloe	クロエ
teamfollowback	チームフォローバック
singapore	シンガポール
colombia	コロンビア
clothes	服
rose	ローズ
sketchbook	スケッチブック
to	に
singer	歌手
strength	力
hungry	空腹
liveauthentic	生得的
sad	悲しい
foto	写真
trustedseller	トラステッドセラー
hawaii	ハワイ
100happydays	100happydays
sunglasses	サングラス
statigram	スタディグラム
texas	テキサス
drink	ドリンク
ilovemydog	私は私の犬が大好き
daughter	娘
heels	かかと
gains	利益
dogoftheday	dogoftheday
arianagrande	アリアナ・グランデ
park	パーク
forest	森林
soccer	サッカー
1d	1d
foodpics	食べ物
trend	傾向
tasmurah	タスマラ
queen	女王
hkig	hkig
hongkong	香港
tea	お茶
quoteoftheday	今日の名言
meow	ニャー
fitlife	フィットライフ
bluesky	青空
pool	プール
cosplay	コスプレ
smiles	笑顔
haircut	ヘアカット
brothers	ブラザーズ
rap	ラップ
river	川
chile	チリ
mountain	山
fitgirl	フィットガール
doodle	いたずら書き
spamforspam	spamforspam
laugh	笑い
homesweethome	ホームスイートホーム
momlife	ママライフ
cooking	料理
guitar	ギター
fire	火災
paint	ペイント
faith	信仰
greece	ギリシャ
lipstick	口紅
healthyeating	健康的な食事
rainbow	虹
sleep	睡眠
dedication	献身
mac	マック
amsterdam	アムステルダム
sydney	シドニー
determination	決定
son	息子
honda	ホンダ
grateful	感謝する
dark	ダーク
skincare	スキンケア
inked	インク入り
sneakers	スニーカー
2013	2013年
festival	フェスティバル
foodpic	おいしい
michaelkors	マイケルコース
apple	林檎
abudhabi	アブダビ
power	パワー
fish	魚
evening	イブニング
pencil	鉛筆
melbourne	メルボルン
glasses	眼鏡
selenagomez	セレナ・ゴメス
bw	bw
glam	グラム
england	イングランド
selfies	セルフ
rip	RIP
inspire	インスピレーション
skyporn	スキポン
blueeyes	青い目
murah	ムラ
hope	希望
moon	月
sushi	寿司
sand	砂
retro	レトロ
izmir	イズミール
lookoftheday	見張りの
church	教会
excited	興奮した
walk	歩く
brooklyn	ブルックリン
asian	アジア人
studio	スタジオ
ny	ニューヨーク
lv	lv
china	中国
jualan	ジュリアン
vape	ヴェイプ
питер	питер
igaddict	igaddict
aesthetic	美的
sleepy	眠いです
xmas	クリスマス
etsy	etsy
horse	うま
following	以下
song	歌
surf	サーフ
vida	ビダ
game	ゲーム
menswear	メンズウェア
beastmode	ビーストモード
team	チーム
nephew	甥
sanfrancisco	サンフランシスコ
portugal	ポルトガル
it	それ
siambrandname	siambrandname
jualanku	ジュランク
healthychoices	健康な選び
hollywood	ハリウッド
girlswholift	ガールズホーリフト
loveyourself	自分を愛する
мода	мода
catlover	キャットオーバー
tourist	ツーリスト
no	いいえ
cloudporn	クラウドポラン
tshirt	Tシャツ
jesus	イエス
cali	カリ
protein	タンパク質
chic	シック
sbn	sbn
progress	進捗
weightlossjourney	体重減少の旅
so	そう
shoutouts	シャウトアウト
tourism	観光
fishing	釣り
trendy	トレンディな
bar	バー
pictures	ピクチャー
fotografia	写真撮影
sepatumurah	セパムラ
bnw	bnw
drunk	酔った
glutenfree	無グルテンの
show	ショー
dank	ダンク
pitbull	ピットブル
believe	信じる
batman	バットマン
for	ために
likeforlikes	likeforlikes
onlineshopping	オンラインショッピング
funtimes	楽しい時間
magic	マジック
restaurant	レストラン
jeans	ジーンズ
猫	猫
3	3
justgoshoot	ジャスト・シュート
original	元の
milano	ミラノ
sports	スポーツ
artofvisuals	アートビジュアル
foodphotography	フードフォトグラフィー
bangkok	バンコク
harrypotter	ハリーポッター
отдых	отдых
legs	足
history	歴史
likebackteam	好きな人
traveler	旅行者
giveaway	与える
girly	ガーリー
sfs	sfs
building	建物
likeall	すべてのように
children	子供
toptags	toptags
sweden	スウェーデン
sandiego	サンディエゴ
chicken	チキン
nightout	夜遊び
twins	双子
fruit	フルーツ
basketball	バスケットボール
watercolor	水彩
hotel	ホテル
dreams	夢
hardwork	ハードワーク
guy	男
healthyliving	健康的な生活
streetwear	ストリートウェア
shooting	射撃
positivevibes	ポジティブな感情
balenciaga	バレンシアガ
together	一緒に
weddingday	結婚式の日
liker	好きな人
domingo	ドミンゴ
glitter	キラキラ
lovelife	愛らしい人
omg	ああ、神様
proud	誇りに思う
jimin	ジミン
v	v
clothing	衣類
colour	色
workhard	職場
marvel	驚異
decoration	装飾
lgbt	lgbt
camera	カメラ
_	_
bbq	bbq
beautifuldestinations	美しい目的地
play	遊びます
brunch	ブランチ
atlanta	アトランタ
waves	波
great	すばらしいです
goodtime	良い時間
disneyland	ディズニーランド
island	島
doha	ドーハ
watch	時計
pokemon	ポケットモンスター
gainpost	ゲインポスト
myworld	私の世界
little	少し
spam4spam	spam4spam
foodlover	恋人
fbf	fbf
likealways	同様に
necklace	ネックレス
puppies	子犬
happyday	幸せ
moments	瞬間
tagsforlikesapp	tagsforlikesapp
hashtag	ハッシュタグ
dc	DC
jungkook	中國
custom	カスタム
reflection	反射
rome	ローマ
petsofinstagram	ペットの姿
wood	木材
poetry	詩
relaxing	リラックス
surabaya	スラバヤ
joy	喜び
dankmemes	ダンクメムズ
out	でる
beautifulday	いい日
silver	銀
argentina	アルゼンチン
vegetarian	ベジタリアン
ysl	ysl
newyorkcity	ニューヨーク市
saturdaynight	土曜日の夜
doubletap	ダブルタップ
rolex	ロレックス
fitmom	フィットマム
camping	キャンプ
kisses	キス
chihuahua	チワワ
bookstagram	ブックマーク
nevergiveup	ネバーギブアップ
roma	ローマ
olshopindo	オルショード
colours	色
girlfriend	ガールフレンド
poland	ポーランド
niece	姪
shredded	細断された
hijabers	ハイジャバ
fashionstyle	ファッションスタイル
coach	コーチ
colorado	コロラド
graphicdesign	グラフィックデザイン
gayboy	ゲイボーイ
taiwan	台湾
regram	regram
fashionable	ファッショナブルな
tas	タス
christmastree	クリスマスツリー
beachlife	ビーチライフ
roses	バラ
japanese	日本語
oldschool	古い学校
army	軍
linda	リンダ
agameoftones	アガモフォンズ
playa	プラヤ
photograph	写真
louboutin	ルブタン
instalife	インスタント
jordan	ヨルダン
cupcakes	カップケーキ
birthdaygirl	誕生日の女の子
glamour	グラマー
instapet	instapet
truelove	真実の恋
active	アクティブ
college	カレッジ
instabeauty	instabeauty
suga	スガ
vans	バン
riodejaneiro	リオデジャネイロ
dxb	dxb
recent4recent	最近の4世紀
country	国
q8	q8
dad	パパ
lastnight	昨夜
makeupaddict	makeupaddict
2018	2018年
stylist	スタイリスト
cheese	チーズ
ford	フォード
is	は
of	の
liketeam	好きな人
hello	こんにちは
actor	俳優
likeme	私のような
eating	食べる
classy	上品な
fashiongram	ファッショングラム
versace	ヴェルサーチ
reading	読書
details	詳細
cheers	乾杯
coffeetime	コーヒータイム
miumiu	ミュウミュウ
miss	ミス
behappy	幸せになる
followtrain	フォロートレイン
plants	植物
grunge	グランジ
perfection	完璧
nomakeup	ノマークアップ
foco	フォコ
norway	ノルウェー
skyline	スカイライン
abstract	抽象
bangtanboys	バンタンボーイズ
metal	金属
curlyhair	curlyhair
collection	コレクション
fashionblog	ファッションブログ
boston	ボストン
salad	サラダ
aesthetics	美学
thebest	最高の
marketing	マーケティング
piccollage	写真のコラージュ
socute	とてもかわいい
nightlife	ナイトライフ
gaming	ゲーム
hairstylist	ヘアスタイリスト
nopainnogain	痛みなくして得るものなし
thanks	ありがとう
wellness	ウェルネス
transformation	変換
gamer	ゲーマー
random	ランダム
young	若い
adoptdontshop	アダプターの採用
jin	ジン
saudiarabia	サウジアラビア
nailpolish	釘付け
travelingram	飛行士
liking	好み
us	米国
neverstopexploring	決して見ることができない
selca	セルカ
delish	デリッシュ
traveller	旅行者
lovemyjob	ラブミージョブ
bird	鳥
naturalhair	ナチュラルヘア
boat	ボート
pop	ポップ
energy	エネルギー
jhope	ジョフ
pnw	pnw
gallery	ギャラリー
artsy	芸術的
cookies	クッキー
cloud	雲
frenchbulldog	フレンチ・ブルドッグ
graduation	卒業
smoke	煙
artoftheday	芸術的なもの
igtravel	igtravel
chillin	チリン
slimmingworld	スリミングワールド
boss	ボス
foodblogger	フードブロガー
comedy	コメディー
clean	クリーン
digitalart	デジタルアート
fashiondiaries	ファッションダイアリー
seattle	シアトル
chilling	冷やす
cousin	いとこ
mother	母
sweets	お菓子
baking	ベーキング
monochrome	モノクロ
harry	ハリー
culture	文化
cosmetics	化粧品
pics	写真
craftbeer	工芸家
nofilterneeded	nofilterneeded
job	ジョブ
bae	ベー
instagrammers	インストラクター
grind	粉砕する
dailylook	デイルローク
earth	地球
healthylife	健康的な生活
thatsdarling	thatsdarling
cocktails	カクテル
cycling	サイクリング
modeling	モデリング
livefolk	ライブフォーク
amigas	アミガ
shirt	シャツ
carporn	カーポン
road	道路
vscophile	ヴィソファイル
noexcuses	言い訳しない
muscles	筋肉
bday	bday
otaku	オタク
simple	単純
like4likes	like4likes
vancouver	バンクーバー
instaday	インスタディ
musica	ミュージカル
thanksgiving	感謝祭
fitspiration	願望
jimmychoo	ジミーチュウ
wonderful	素晴らしい
brown	褐色
bed	ベッド
boutique	ブティック
leather	レザー
kloset	クローゼット
club	クラブ
instafamous	体系的な
de	デ
5sos	5ソス
strawberry	イチゴ
mare	メア
mygirl	マイガール
go	行く
skirt	スカート
instafun	イスタンブール
converse	話す
motd	モート
chef	シェフ
riyadh	リヤド
vinyl	ビニール
snapshot	スナップショット
swimming	水泳
crochet	かぎ針編み
ireland	アイルランド
favorite	お気に入り
menstyle	男性型
myself	私自身
instaboy	instaboy
warm	暖かい
bvlgari	ブルガリ
respect	尊敬
styleblogger	スタイルブログ
legend	伝説
squats	スクワット
sp	sp
soul	魂
africa	アフリカ
recentforrecent	最近の
graphic	グラフィック
lifeisgood	人生は素晴らしい
myboy	私の息子
lashes	まつげ
puppiesofinstagram	パピー
humor	ユーモア
positive	ポジティブ
manicure	マニキュア
hilarious	陽気な
dancer	ダンサー
band	バンド
topshop	topshop
tagsforlike	tagsforlike
real	リアル
weddingdress	ウェディングドレス
haircolor	髪の色
tagforlikes	tagforlikes
bracelet	ブレスレット
vip	VIP
travelblogger	travelblogger
bestie	ベスト
switzerland	スイス
italian	イタリアの
golf	ゴルフ
sayajualmurah	エスパニョーラ
girlswithtattoos	ガールズスイスタトゥー
pen	ペン
silly	愚かな
moodygrams	ムーディーグラム
wild	野生
downtown	ダウンタウン
walking	歩く
online	オンライン
thursday	木曜日
ps4	ps4
baju	バジュ
missyou	あなたがいなくて寂しいです
lady	レディ
facebook	フェイスブック
instakids	インサキッズ
depression	うつ病
shoplocal	ショオフォーカル
pug	パグ
babies	赤ちゃん
tour	ツアー
4	4
wildlife	野生動物
curls	カール
angel	天使
capture	キャプチャー
minimal	最小限
meditation	瞑想
nomnom	ノーノム
instahealth	インスリン
pasta	パスタ
hat	帽子
support	サポート
streetfashion	ストリートファッション
readystock	在庫有り
milan	ミラノ
ice	氷
louis	ルイス
lynaround	リラックス
houston	ヒューストン
hk	香港
ready	準備完了
tasbranded	タスブラッド
justdoit	早くやれよ
star	星
gymrat	ジムラート
babyshower	ベビーシャワー
hijabfashion	ヒジャブファッション
igersitalia	igersitalia
cinema	シネマ
contemporaryart	現代美術
philippines	フィリピン
daddy	パパ
skate	スケート
epic	エピック
tv	テレビ
sepatu	Sepatu
bridge	ブリッジ
personaltrainer	個人トレーナー
lmfao	イムファオ
celebration	お祝い
petsagram	ペツトグラム
taylorswift	テイラースウィフト
event	イベント
amore	もっと
king	キング
brand	ブランド
manhattan	マンハッタン
beast	獣
trustedolshop	トラストルズショップ
paz	パス
korean	韓国語
tiffany	ティファニー
back	バック
visualsoflife	visualsoflife
olshopmurah	オルショクラ
tuesday	火曜日
physique	体格
bro	仲間
praia	プラヤ
trainhard	がんばれ
french	フランス語
photoshop	フォトショップ
ride	ライド
xbox	xbox
fly	飛ぶ
anastasiabeverlyhills	アナスタシバブリーヒルズ
herbalife	ハーバライフ
big	大きい
jdm	jdm
jewellery	ジュエリー
ukraine	ウクライナ
rapmonster	ラップモンスター
facts	事実
winning	勝つ
emo	エモ
floral	花
wednesday	水曜日
her	彼女
bags	バッグ
jualbaju	ジュバルバジュ
sneakerhead	スニーカーヘッド
redlips	赤い唇
bigbang	ビッグ・バン
vibes	バイブ
composition	組成
mothersday	母の日
on	に
dayoff	休みの日
unique	ユニークな
_	_
mytravelgram	筋トレ
ferrari	フェラーリ
vscorussia	vscorussia
movies	映画
catoftheday	catoftheday
raw	生
this	この
tag	タグ
plantbased	プラントベースの
audi	アウディ
squad	分隊
grey	グレー
islam	イスラム教
boxing	ボクシング
yay	わーい
ring	リング
birds	鳥
vogue	流行
gamis	ゲーム
edit	編集
foods	食べ物
purse	財布
passionpassport	passionpassport
instahappy	インスパイア
goodlife	いい人生
october	10月
help	助けて
baseball	野球
flashbackfriday	フラッシュバックフライデー
namaste	ナマステ
turnup	現れる
sleeping	睡眠
filter	フィルタ
vietnam	ベトナム
vapelife	ヴァパリフェ
hipster	ヒップスター
working	ワーキング
yogaeverydamnday	yogaeverydamnday
vscogrid	vscogrid
nba	Nba
kidsfashion	キッズファッション
paper	紙
one	1
games	ゲーム
pose	ポーズ
sony	ソニー
mercedes	メルセデス
instacute	インスタント
nerd	オタク
earrings	イヤリング
transformationtuesday	transformationtuesday
tattooed	入れ墨された
frozen	フローズン
datenight	デートの夜
boots	ブーツ
musthave	持つ必要があります
bf	bf
vacaciones	バカシオン
navidad	ナビダッド
high	高い
qotd	qotd
fridaynight	金曜日の夜
now	今
ferragamo	フェラガモ
museum	博物館
loveofmylife	人生最愛の人
dancing	ダンシング
fitnessjourney	フィットネスジャーニー
instanature	インスタント
scenery	風景
solo	ソロ
modern	モダン
atl	atl
weddingphotography	結婚式の写真
paleo	古代
sharjah	シャルジャ
hairstyles	ヘアスタイル
selflove	自制
mommy	ママ
redhair	赤毛
tan	タン
dead	デッド
espaa	エスパ
antalya	アンタルヤ
journey	旅
2012	2012年
fanart	ファンアート
present	プレゼント
toyota	トヨタ
instaselfie	インスパイア
bulldog	ブルドッグ
dressmurah	ドレスムラ
pup	子犬
scotland	スコットランド
orlando	オーランド
instaartist	インストラクター
gifts	ギフト
vw	VW
comics	漫画
pastel	パステル
naturelover	自然が好きな人
candy	キャンディー
kitchen	キッチン
retrica	レトリカ
do	行う
stunning	見事な
mma	mma
estilo	エステロ
blackandwhitephotography	黒と白の写真
yamaha	ヤマハ
shopsmall	ショップ小屋
realestate	不動産
banana	バナナ
casual	カジュアル
milin	ミリン
zayn	ゼイ
natureza	ネイザ
spam	スパム
share	シェア
hustle	ハッスル
motorcycle	オートバイ
r4r	r4r
bodybuilder	ボディービルダー
denim	デニム
reseller	リセラー
outdoor	屋外
wip	ワイプ
legday	脚本
arizona	アリゾナ州
change	変化する
medan	メダン
followforlike	followforlike
airport	空港
ibiza	イビサ
instafitness	インスタント証人
instatraveling	instatraveling
instalikes	インスタントライツ
gm	gm
yesterday	昨日
guys	みんな
spb	spb
mama	ママ
forsale	forsale
amomuito	アモミート
liam	リャム
rainyday	雨の日
mine	鉱山
actress	女優
foodies	食べ物
siblings	兄弟
goldenretriever	ゴールデンレトリバー
maccosmetics	maccosmetics
selfietime	自立
fat	脂肪
lift	リフト
xoxo	XO XO
niall	ナイオール
flowerstagram	フラワーストラグ
words	言葉
office	事務所
bridal	ブライダル
alternative	代替
livemusic	ライブ音楽
frenchie	フレンチ
promo	プロモーション
sorrynotsorry	申し訳ありません
magazine	マガジン
realtalk	リアルトーク
labrador	ラブラドール
mothernature	母なる自然
seoul	ソウル
hudabeauty	Hudabeauty
musician	ミュージシャン
buongiorno	ブンゴノノ
heaven	天国
makeuplover	makeuplover
future	未来
barber	理容師
fashionaddict	ファッションアクト
hike	ハイキング
5	5
nissan	日産
lyn	Lyn
depressed	落ち込んだ
finally	最後に
mode	モード
stars	星
gymtime	ジムタイム
rj	rj
bunny	バニー
make	作る
35mm	35mm
jualansis	ジュリアンシス
afternoon	午後
newborn	新生児
instamakeup	インスタントメークアップ
polishboy	ポリッシュボーイ
got7	got7
panama	パナマ
batik	バティック
runner	ランナー
supernatural	超自然的
hijabstyle	ヒジャーブスタイル
egypt	エジプト
inspo	インスピ
anniversary	記念日
bands	バンド
weddings	結婚式
news	ニュース
caracas	カラカス
instapassport	インスパイアポート
all	すべて
makeupjunkie	メイクアップジャンク
surprise	驚き
baekhyun	白雲
craft	クラフト
montreal	モントリオール
furniture	家具
flawless	完璧な
godisgood	神は良いです
blouse	ブラウス
oman	オマン
place	場所
racing	レース
trusted	信頼できる
class	クラス
austria	オーストリア
prague	プラハ
yes	はい
fashionweek	ファッションウィーク
flex	フレックス
cartoon	漫画
jualankaka	ジャランカカ
jualtas	ユルタ
producer	プロデューサー
cannabis	大麻
tasimport	大量輸入
squat	スクワット
porsche	ポルシェ
fireworks	花火
skull	頭蓋骨
jj_forum	jj_forum
outside	外側
fitgirls	フィットガールズ
traveltheworld	世界を旅する
dallas	ダラス
igersoftheday	igersoftheday
waterfall	滝
takemeback	連れ帰ってください
myeverything	私の全て
sick	病気
up	アップ
chanyeol	チャニョール
happyfriday	ハッピー・フライデー
cover	カバー
iphoneography	iphoneography
macro	マクロ
familyfirst	家族第一
iphone6	iphone 6
skylovers	スカイオーバー
b	b
mtb	mtb
hypebeast	hypebeast
balance	バランス
instapuppy	不器用な
eyebrows	眉毛
onelove	一つの愛
peaceful	平和な
horses	馬
kittens	子猫
december	12月
redhead	赤毛
newzealand	ニュージーランド
_	_
lazy	怠惰な
diva	歌姫
horror	ホラー
shadow	影
comingsoon	近日公開
neko	猫
detox	デトックス
we	我々
tbh	tbh
wisdom	知恵
valencia	バレンシア
ombre	オムブレ
happyhalloween	ハッピーハロウィーン
vscodaily	vscodaily
fiesta	フィエスタ
mango	マンゴー
artistic	芸術的
bass	ベース
exploretocreate	exploretocreate
lego	レゴ
nailswag	ネイルスワッグ
truestory	実話
squaready	角形
sehun	セフン
illustrator	イラストレーター
pride	誇り
inspired	インスピレーションを受けた
dt	dt
nature_perfection	nature_perfection
kai	カイ
blondehair	ブロンドヘア
маникюр	маникюр
fluffy	ふわふわした
deus	デウス
toys	おもちゃ
word	ワード
alain	アレイン
rihanna	リハナ
naruto	ナルト
vegansofig	ビーガンソフ
kyliejenner	カイリエナーナー
dagelan	ダグラン
supreme	最高
smallbusiness	小規模なビジネス
snack	スナック
speed	速度
puertorico	プエルトリコ
ilovemycat	私は私の猫を愛します
bikelife	バイクライフ
hijabmurah	ヒジャブムラ
ladies	女性
весна	весна
weightlifting	重量挙げ
bella	ベラ
beats	ビート
textgram	テキストグラム
amen	アーメン
dieta	食餌療法
wwe	ウィー
positivity	陽性
stance	スタンス
kid	キッド
bazaarpaknil	バザカルクニル
ripped	裂けた
ginger	ショウガ
burger	バーガー
sculpture	彫刻
sabado	サバド
happygirl	ハッピーガール
interiors	インテリア
samsung	サムスン
gratitude	感謝
lebanon	レバノン
venice	ベニス
special	特別
child	子
shoutoutforshoutout	shoutoutforshoutout
youtuber	あなた
nfl	nfl
glass	ガラス
hamburg	ハンブルグ
eye	眼
famous	有名な
lovedogs	愛する人たち
futbol	フットボール
casamento	カザメント
sweater	セーター
eyeshadow	アイシャドウ
dogsofinsta	dogsofinsta
kicks	キック
punk	パンク
husky	ハスキー
elegant	エレガント
happysunday	良い日曜日を
eeeeeats	eeeeeats
bear	くま
desert	砂漠
lucky	幸運な
sweat	汗
be	〜する
seafood	シーフード
monster	モンスター
daddysgirl	daddysgirl
deontem	デントン
motivated	意欲的な
cantik	カンティク
selfiesunday	自尊心
lamborghini	ランボルギーニ
shoutout4shoutout	shoutout4shoutout
jacket	ジャケット
surfing	サーフィン
lindo	リンゴ
wiwt	ワウティ
instamusic	インストゥルメンタル
skin	肌
childhood	子供時代
natgeo	ナットジオ
whatiwore	何
olshopjakarta	オルショクジャカルタ
champagne	シャンパン
study	調査
twitter	ツイッター
grass	草
powerlifting	パワーリフティング
chilegram	チリグラム
disaya	ディヤヤ
cantwait	待てません
getoutside	ゲットサイド
prom	プロム
pregnant	妊娠している
drive	ドライブ
taehyung	テヒョン
vscogram	vscogram
21	21
fashionpost	ファッションポスト
celebrate	祝う
traditional	伝統的な
jeep	ジープ
marijuana	マリファナ
comments	コメント
videogames	ビデオゲーム
осень	осень
chevy	シェビー
seaside	シーサイド
iran	イラン
highlife	上流社会
turbo	ターボ
newcollection	新しいコレクション
croatia	クロアチア
nailstagram	ネイルストラグ
ilovemyjob	私の仕事が大好きです
workinprogress	作業中の進行
sogood	とても良い
travelblog	travelblog
directioner	指揮官
badass	悪い
buildings	建物
jam	ジャム
xboxone	xboxone
butterfly	バタフライ
castle	城
win	勝つ
longhairdontcare	長髪のドントケア
l	l
iifym	アイフィム
sf	sf
southafrica	南アフリカ
c4c	c4c
cupcake	カップケーキ
naturaleza	ナチュラレザ
philly	フィリー
стиль	стиль
fineart	美術品
israel	イスラエル
sixpack	6パック
curly	縮れた
shoot	シュート
eyeliner	アイライナー
exok	エキソク
doggy	犬
partytime	パーティーの時間
festa	フェスタ
pumpkin	かぼちゃ
mia	ミア
lit	点灯
toddler	幼児
romantic	ロマンチック
saopaulo	サンパウロ
m	m
balayage	バラヤージュ
challenge	チャレンジ
zoo	動物園
citylife	街の暮らし
indian	インディアン
18	18
nintendo	任天堂
practice	練習
indie	インディー
november	11月
mi	ミミ
grosir	グロッシル
exposure	暴露
gf	gf
barbershop	理髪店
student	学生
letsgo	行こう
bookworm	ブックワーム
myson	マイソン
netherlands	オランダ
realmadrid	レアル_マドリード
exol	エクオール
arts	芸術
travels	旅行
свадьба	свадьба
window	窓
deusnocomando	デュノノコマンド
superman	スーパーマン
casa	カサ
goodfood	いい食べ物
cut	カット
bmx	bmx
bebe	ビービー
instagramdogs	Instagramdogs
lookdodia	ルドドディア
feet	フィート
visiting	訪問する
myheart	私の心
slimmingworlduk	スリミングウォルドゥク
jokes	ジョーク
vscoph	vscoph
jogja	ジョグジャ
first	最初
local	地元
oregon	オレゴン
collage	コラージュ
edgy	鋭い
spa	スパ
views	再生回数
instagramer	インストラクター
wall	壁
dancemoms	ダンスママ
obsessed	執拗な
bursa	嚢
tods	トッズ
rio	リオ
luxurylife	ルクスリライフ
diamond	ダイヤモンド
wakeupandmakeup	wakeupandmakeup
partiu	パーティー
streetdreamsmag	streetdreamsmag
staystrong	強く生きろ
lukehemmings	恋人
geek	オタク
fitnessgirl	フィットネスガール
graphics	グラフィックス
я	я
jamtangan	ジャムタンガン
drake	ドレーク
doglife	犬の生活
hellokitty	ハローキティ
buenosdias	ブエノスアイレス
fitfood	フィットフード
farm	ファーム
pattern	パターン
lowcarb	低炭水化物
bacon	ベーコン
siguemeytesigo	シグマエテゴシゴ
super	スーパー
eggs	卵
urbanart	都市部
instanails	インスタント
sretsis	スレイチス
drawings	図面
lifeofadventure	lifeofadventure
toocute	toocute
pants	ズボン
furbaby	ファラビー
race	レース
ig_captures	ig_captures
fruits	果物
muslim	イスラム教徒
minimalism	ミニマリズム
husband	夫
wiw	ワウ
at	〜で
f	f
doglovers	ドッグオーバー
piercing	穿刺
gainz	ゲインズ
hobby	趣味
cuddles	抱擁
fam	ファム
tagstagram	タグ
yogi	ヨギ
university	大学
birthdaycake	誕生日ケーキ
pray	祈る
stockholm	ストックホルム
gato	ガート
vapeporn	バポンポン
weird	奇妙な
rabbit	ウサギ
landscapephotography	風景写真
gamismurah	ガミズムラ
manchester	マンチェスター
lovemylife	私の人生を愛する
athlete	アスリート
greeneyes	緑の目
jual	ジュール
instaframe	インスタントフレーム
kyoto	京都
santa	サンタ
snapseed	盗んだ
naildesign	ネイルデザイン
pokemongo	ポケモンゴ
ballet	バレエ
writer	ライター
flores	フロア
enjoylife	人生を楽しむ
mini	ミニ
scary	怖い
knitting	編み物
calumhood	カリキュラム
mum	ママ
carnaval	カーニバル
girlboss	ガールズボス
instaquote	インストラクション
etsyshop	etsyshop
smoothie	スムージー
summer2017	夏
furry	毛むくじゃら
buenasnoches	ブナナノシェ
fight	戦い
ashtonirwin	アーストンウィン
likeit	いいね
waiting	待っている
природа	природа
naturalbeauty	自然の美
спб	спб
writing	書き込み
jazz	ジャズ
finland	フィンランド
счастье	счастье
frio	フリーオ
felicidad	フェリシダ
bright	明るい
viernes	ビエネス
town	タウン
veganfood	ビーガンフード
lyrics	歌詞
perspective	視点
blond	ブロンド
npc	npc
nashville	ナッシュビル
twentyonepilots	十二の弟子
ff	ff
nomnomnom	ノーノムノム
babylove	ベイビーラブ
spoiled	甘やかされた
jualsepatu	ジャルセパツ
fujifilm	フジフィルム
styling	スタイリング
michaelclifford	マイケルクリフォード
princesa	プリンセサ
dresses	ドレス
errejota	エルレゴタ
mar	マル
musically	音楽的に
instashop	インスタントショー
alcohol	アルコール
girlsnight	女の子の夜
nothingisordinary	何もない
colourful	カラフル
detroit	デトロイト
loveislove	愛は愛
7	7
playstation	プレイステーション
shorthair	ショートヘア
creativity	創造性
marriage	結婚
ak	ak
90s	90年代
piano	ピアノ
dogs_of_instagram	dogs_of_instagram
fashionphotography	ファッションフォトグラフィー
pain	痛み
bread	パン
bjj	bjj
catlovers	キャットオーバー
singing	歌う
ss	SS
mensstyle	メンズスタイル
countryside	田舎
space	スペース
sole	唯一
performance	パフォーマンス
hard	ハード
dogsofig	dogsfig
budapest	ブダペスト
golden	ゴールデン
salon	サロン
not	ない
idol	アイドル
honeymoon	ハネムーン
osaka	大阪
peru	ペルー
myart	私の作品
veganfoodshare	ビーガンフードシェア
funday	楽しい日
swim	泳ぐ
mumbai	ムンバイ
logo	ロゴ
dapper	大胆な
taipei	タイペイ
boom	ブーム
nye	ナイ
hi	こんにちは
barberlife	バーバーライフ
self	自己
iloveit	大好きです
semarang	セマラン
father	お父さん
lunchtime	ランチタイム
winner	勝者
comment4comment	コメント4コメント
spiderman	スパイダーマン
piercings	ピアス
shine	輝く
merica	メリカ
gamissyari	ガニシヤリ
fail	失敗します
exom	exom
can	できる
washington	ワシントン
girlpower	女の子のパワー
whatveganseat	whatveganseat
nutella	栄養素
cocktail	カクテル
fast	速い
timehop	タイムショップ
6	6
napoli	ナポリ
sketching	スケッチ
rayban	レイバン
beforeandafter	前から後
suho	スホ
womensfashion	レディースファッション
wakeup	目を覚ます
belgium	ベルギー
valentines	バレンタイン
bajuimport	バギイポート
cancer	癌
backpacking	バックパッキング
archilovers	アーチアンバー
polo	ポロ
igworldclub	igworldclub
girlswithmuscle	少女時代
way2ill	way2ill
bye	バイ
groom	新郎
gaintrick	ゲイントリック
lay	寝る
hippie	ヒッピー
savage	野蛮人
sis	シス
denver	デンバー
xiumin	キシリン
toy	おもちゃ
veggies	野菜
710	710
10	10
qualitytime	充実した時間
cringe	うんざりする
after	後
kimkardashian	キムカーダシアン
motherhood	母性
adventures	冒険
mydog	うちの犬
blood	血液
weddingphotographer	結婚式の写真家
yo	よ
saudi	サウジ
pitbullsofinstagram	pitbullsofinstagram
socal	ソカル
steak	ステーキ
branding	ブランディング
bangtan	バンタン
living	生活
minecraft	マインクラフト
igmasters	igmasters
long	長いです
happyhour	幸せな時間
onepiece	ワンピース
cream	クリーム
editorial	編集
watches	時計
socialmedia	ソーシャルメディア
bffs	bffs
sinfiltro	sinfiltro
hbd	hbd
gameofthrones	ゲーム・オブ・スローンズ
bollywood	ボリウッド
fashionkids	ファッションキーズ
instapicture	事実
blondie	ブロンド
bazarpaknil	バザカルクイル
bajuanak	バジュアナク
verano	ベラノ
typography	タイポグラフィ
scene	シーン
ifollowback	ifollowback
cuties	かわい子
summer2016	夏
loveu	恋人
семья	семья
costume	コスチューム
beachbody	ビーチボディー
cannabiscommunity	大麻コミュニティー
pomeranian	ポメラニアン
chen	陳
read	読む
poodle	プードル
deutschland	ドイツ
panorama	パノラマ
mustang	マストン
print	印刷する
iphone5	iPhone 5
bangtansonyeondan	バンタンソン延ダン
westcoast	西海岸
polish	研磨
ifbb	ifbb
followus	フォローする
portland	ポートランド
3d	3D
create	作成する
ana	アナ
denmark	デンマーク
silhouette	シルエット
дети	дети
cakes	ケーキ
done	完了
instamoments	インスタント
him	彼
austin	オースティン
september	9月
sommer	ソマー
ig_europe	ig_europe
buenosaires	ブエノスアイレス
vienna	ウィーン
dachshund	ダックスフント
cityscape	都市景観
feedfeed	フィードフィード
igsneakercommunity	igsneakercommunity
10likes	10件の
dublin	ダブリン
kotd	kotd
cloudy	曇った
just	ちょうど
sunlight	太陽光
ecuador	エクアドル
ps3	ps3
germanshepherd	ジャーマンシェパード
bajumuslim	バジュムスリム
iphonephotography	iphonephotography
weights	重み
bridetobe	ブリッジドベ
supercar	スーパーカー
vapelyfe	vapelyfe
sunsets	夕焼け
kiev	キエフ
nikonphotography	ニコンフォトグラフィー
happyholidays	ハッピーホリデー
saude	サウード
radio	無線
catsagram	キャッツグラム
фото	фото
kwankao	クワンカオ
ski	スキー
armani	アルマーニ
trap	トラップ
portraitphotography	肖像写真
d	d
horizon	地平線
events	イベント
techno	テクノ
italiangirl	italiangirl
handbag	ハンドバッグ
stoner	ストーナー
spiritual	スピリチュアル
mystyle	私のスタイル
inktober	インクトーバー
worldwide	世界的に
modafeminina	モダフィミニナ
trust	信頼
weddinginspiration	結婚願望
tattooartist	タトゥーアーティスト
mygirls	マイガールズ
trump	トランプ
rave	レイブ
lace	レース
community	コミュニティ
muslimah	ムスリムア
bogota	ボゴタ
dusk	夕暮れ
jump	ジャンプ
ootn	オットン
latina	ラティーナ
huzur	フーズル
flashesofdelight	フラシェソライト
recovery	回復
playing	遊ぶ
ig_worldclub	ig_worldclub
instavideo	instavideo
gang_family	gang_family
kualalumpur	クアラルンプール
champion	チャンピオン
weeklyfluff	週刊フラフフ
yeezy	イージー
acrylic	アクリル
chat	チャット
jamtanganmurah	ジャムタンガンムラ
storm	嵐
morocco	モロッコ
everyday	毎日
highsociety	ハイソサイエティ
спорт	спорт
100	100
hockey	ホッケー
instame	インメット
abstractart	抽象芸術
exploremore	エクスプロアモモ
goth	ゴス
kicksonfire	キックソンファイア
mondaymotivation	モンダイモチベーション
doll	人形
carswithoutlimits	carswithoutlimits
dccomics	人間関係
areeya	アステヤ
e	e
dropship	ドロップシップ
calm	落ち着いた
hunting	狩猟
thai	タイ
pancakes	パンケーキ
latte	ラテ
tonight	今晩
lovecats	ラブキャッチ
moto	モト
handcrafted	手作り
talent	才能
igshop	igshop
illgrammers	プログラマー
rocknroll	ロックンロール
instahair	イスタンブール
offroad	未舗装道路
case	場合
architecturelovers	architecturelovers
blackcat	黒猫
dolcegabbana	ドルチェガバナ
fashionshow	ファッションショー
santiago	サンティアゴ
poem	詩
fan	ファン
rescue	レスキュー
selfienation	自己志向
rich	リッチ
subaru	スバル
neon	ネオン
snsd	snsd
alhamdulillah	alhamdulillah
goodfriends	良い友達
georgia	ジョージア
salud	サルード
kush	クッシュ
dreambig	ドリームビッグ
bajucewek	バジュズワク
hdr	hdr
birthdayboy	誕生日の男の子
vapecommunity	地域社会
summervibes	サマービーブ
mermaid	マーメイド
playtime	遊びの時間
fantasy	ファンタジー
rnb	rnb
tags	タグ
estate	エステート
last	最終
5secondsofsummer	夏の5秒
ufc	ufc
23	23
temple	寺院
engagement	エンゲージメント
coffeelover	コーヒーを飲む
vine	ぶどうの木
picsart	ピクサー
wonderful_places	wonderful_places
chinese	中国語
boxer	ボクサー
urbandecay	urbandecay
woods	森
authentic	本物の
jb	jb
mexican	メキシコ人
sicily	シチリア島
malang	マラン
volkswagen	フォルクスワーゲン
ironman	鉄人
project	プロジェクト
oc	OA
twilight	トワイライト
harleydavidson	ハーレーダビッドソン
islandlife	アイランドライフ
gardening	園芸
kekinian	ケキニア人
pilates	ピラティス
mutluluk	ミュートル
cook	クック
vapefam	vapefam
desserts	デザート
creepy	気味悪い
tunik	チューニク
newmusic	新しい音楽
calligraphy	書道
lovers	恋人
ferias	フェリアス
drums	ドラム
digital	デジタル
hkigshop	hkigshop
quality	品質
strawberries	いちご
diamonds	ダイヤモンド
primavera	プリマベラ
by	〜によって
theatre	劇場
lettering	レタリング
murahmeriah	ムラメリア
exhibition	展示会
vapeon	バプソン
follow4like	follow4like
ugg	ugg
braids	編組
puma	プーマ
happyeaster	イースター、おめでとう
american	アメリカ人
halamadrid	ハラマドリード
gelnails	ゲルネイル
thehappynow	Thehappynow
natura	ナチュラ
costarica	コスタリカ
bedtime	就寝時間
springbreak	春休み
goodmusic	良い音楽
precious	貴重な
calor	カロリー
20	20
parkjimin	パークジミン
unicorn	ユニコーン
ig_kids	ig_kids
likers	好きな人
followshoutoutlikecomment	followshoutoutlikecomment
messi	メッシー
treino	トリーノ
curves	カーブ
vegetables	野菜
fabulous	素晴らしい
vodka	ウォッカ
thoughts	思考
myboys	マイボーイ
candles	ろうそく
zen	禅
teatime	お茶の時間
demilovato	デミロヴァト
perfume	香水
anxiety	不安
sepatucewek	Sepatucewek
education	教育
avocado	アボカド
myfamily	私の家族
gratido	グレティード
engaged	従事する
iceland	アイスランド
hechoamano	ヘコアマノ
artgallery	アートギャラリー
plussize	プラスサイズ
rescuedog	レスキュードッグ
disneyworld	ディズニーワールド
edc	EDC
kickstagram	キックバックグラウンド
season	シーズン
sneaker	スニーカー
amiga	アミガ
japanesefood	japanesefood
preorder	予約注文
exploring	探検する
utah	ユタ
hahaha	ははは
newbalance	ニューバランス
liebe	嘘つき
mind	マインド
hugs	抱擁
iphonography	イコノグラフィー
masterpiece	傑作
fifa	FIFA
miamibeach	マイアミビーチ
famlia	ファムリア
tropical	トロピカル
celebrity	有名人
filmphotography	フィルム写真
natal	出生
hm	hm
story	ストーリー
commentforcomment	コメントのコメント
tumblrgirl	tumblrgirl
rosa	ロザ
ikea	イケア
bad	悪い
what	何
instamagandroid	インスタントマガジン
openrp	openrp
please	お願いします
healing	ヒーリング
hermosa	ハーモサ
thewalkingdead	ウォーキング・デッド
commentback	コメント
tendencia	トレンド
autism	自閉症
jualanmurah	ジュランムラ
fandom	ファンダム
fangirl	fangirl
plant	工場
relationshipgoals	関係の目標
instatag	instatag
trends	トレンド
s	s
зима	зима
shihtzu	シツ
kimtaehyung	キムヒョン
fitchick	フィッチ
вечер	вечер
gayguy	ゲイの男
гельлак	гельлак
_	_
want	欲しいです
lover	恋人
comic	漫画
chromehearts	クロムハーツ
honey	はちみつ
netflix	ネットフリックス
fotorus	写真
suicide	自殺
shanghai	上海
aviation	航空
animegirl	アニメガール
kaos	カオス
wings	翼
likeforlikealways	好きなように
competition	コンペ
skateboard	スケートボード
kenzo	謙三
followmeplease	こちらへどうぞ
hediye	ヘディエ
beagle	ビーグル
couture	クチュール
munich	ミュンヘン
presents	プレゼント
nochill	ノーチル
lovinglife	愛する人
sweettooth	甘いもの
cactus	カクタス
scarf	スカーフ
fmsphotoaday	fmsphotoaday
pregnancy	妊娠
auto	オート
hand	ハンド
feeling	感じ
22	22
wife	妻
lines	行
holland	オランダ
post	役職
air	空気
fathersday	父の日
slay	殺す
salmon	サーモン
suit	スーツ
bohemian	ボヘミアン
queens	女王
leo	レオ
dodge	かわす
funnymemes	コメディアン
hairdresser	美容師
tagsta	タグスタ
hookah	ホッカ
airplane	飛行機
nostalgia	ノスタルジア
madeinitaly	イタリア製
happylife	幸せな生活
beyourself	素直になれ
arquitetura	Arquitetura
bayarea	ベイエリア
rapper	ラッパー
hashtags	ハッシュタグ
natur	ナチュラル
pleaselike	pleaselike
iger	iger
hero	ヒーロー
springtime	春
mealprep	mealprep
android	アンドロイド
fog	霧
joke	冗談で
versagram	同義語
medellin	メデリン
shades	陰影
trkiye	トラキエ
juice	ジュース
bestseller	ベスト・セラー
portraits	肖像画
mobilephotography	携帯写真
gymmotivation	ジムモチベーション
nola	ノーラ
birthdayparty	誕生日会
climbing	クライミング
ねこ	ねこ
stone	石
ontheroad	路上で
phan	ファン
puglife	パグ生活
navy	海軍
crueltyfree	残酷なフリー
tao	タオ
fairytail	フェアリーテイル
military	軍事
frases	frases
flying	飛行
melanin	メラニン
jiujitsu	柔術
startup	起動
wila	ウィラ
цветы	цветы
tasbatam	タスバタム
lifestyleblogger	ライフスタイルブロガー
gymnastics	体操
christmastime	クリスマスの時期
snowboarding	スノーボード
утро	утро
czech	チェコ
fancy	ファンシー
eathealthy	健康的に食べる
adventuretime	冒険の時間
hkgirl	hkgirl
larrystylinson	ラリジリシン
grow	成長する
tattooart	タトゥーアート
housemusic	ハウスミュージック
reggae	レゲエ
shellac	シェラック
trocolikes	トロコライク
igersjp	igersjp
doctorwho	ドクター・フー
rocks	岩
ralphlauren	ラルフローレン
brows	眉
8	8
yyc	イーシー
bedroom	寝室
blacklivesmatter	ブラックライフマター
candid	率直
capetown	ケープタウン
люблю	かわいい
lovequotes	愛の言葉
minyoongi	ミョンヨン
attackontitan	進撃の巨人
line	ライン
mindset	考え方
guns	銃
plane	飛行機
outfitpost	外出先
loewe	ロウエ
rest	残り
goal	ゴール
9	9
flipagram	フリップグラム
gta5	グランド・セフト・オート5
happymothersday	母の日おめでとう
instashot	打ち上げ
death	死
blackfriday	ブラックフライデー
swimwear	水着
ohio	オハイオ州
yogyakarta	ジョグジャカルタ
adoro	アードロ
delicia	デリシア
luna	ルナ
handmadejewelry	ハンドメイドジュエリー
malemodel	マルモデル
butik	ブティック
peoplescreatives	人々のクリエイティブ
wave	波
подарок	подарок
4thofjuly	7月4日
jaspal	ジャスパー
minions	ミニオン
ask	尋ねる
sw	sw
modernart	モダンアート
gta	gta
remember	思い出す
fitnesslifestyle	フィットネスライフスタイル
bicycle	自転車
copenhagen	コペンハーゲン
fashiondesigner	ファッションデザイナー
highheels	ハイヒール
fox	狐
kemeja	ケメジャ
foodgram	フードグラム
pandora	パンドラ
luxurylifestyle	贅沢なスタイル
kayasis	カヤシス
muaythai	ムエタイ
exploreeverything	exploreeverything
blackgirlmagic	ブラックガールマジック
thuglife	サグ・ライフ
vintagestyle	ビンテージ・スタイル
market	市場
filthyfrank	汚いフランク
fblogger	fblogger
ногти	ногти
vacances	バカンス
hate	嫌い
девочкитакиедевочки	девочкитакиедевочки
sparkle	輝く
instalook	インスタレーション
ball	玉
songs	曲
stripes	ストライプ
artistsoninstagram	Artistsoninstagram
larry	ラリー
brisbane	ブリスベン
nicekicks	ニックキックス
ever	これまで
краснодар	краснодар
liverpool	リバプール
skinny	スキニー
yeah	ええ
igfitness	igfitness
biceps	上腕二頭筋
bbg	bbg
en	エン
antique	アンティーク
17	17
etsyseller	etsyseller
fashionlover	ファッションオーバー
cheesecake	チーズケーキ
cdmx	cdmx
instablogger	インスタブロガー
blackhair	ブラックヘアー
artists	アーティスト
relationship	関係
vapenation	化粧
objektifimden	オブジェクティフミン
exclusive	排他的
swarovski	スワロフスキー
vegas_nay	vegas_nay
ручнаяработа	ручнаяработа
valentine	バレンタイン
inspirational	インスピレーション
wildernessculture	野生生物
sing	歌う
kaosmurah	カオスムラ
happymonday	ハッピーマンデー
neworleans	ニューオーリンズ
cozy	居心地の良い
yorkie	ヨーキー
cuba	キューバ
break	ブレーク
english	英語
gourmet	グルメ
allah	アッラー
mask	マスク
jilbab	ジルバブ
trending	トレンド
foodblog	foodblog
runway	滑走路
musical	ミュージカル
dabs	ダブ
красиво	красиво
piscina	魚釣り
exklusive_shot	exklusive_shot
instadogs	スタンド
photoftheday	光時代
solecollector	ソールコレクター
got	持っている
galaxy	銀河
candle	キャンドル
jamaica	ジャマイカ
gentleman	紳士
blousemurah	ブルースミュラ
palembang	パレンバン
marcjacobs	marcjacobs
laughing	笑い
entrepreneurship	起業家精神
blossom	花
работа	работа
pub	パブ
bible	聖書
lemon	レモン
beardgang	ビードガング
soon	すぐに
cheflife	シェフリフ
matilda	マチルダ
christian	キリスト教の
cosmetic	化粧品
maquiagem	マキアエル
lifequotes	人生相談
80s	80年代
minimalist	ミニマリスト
naptime	昼寝の時間
nikeplus	ナイフプラス
crystals	結晶
одежда	одежда
kawasaki	川崎
shots	ショット
shoutoutback	シャウトアウトバック
lifting	持ち上げる
jeonjungkook	ジョンクククク
rice	ご飯
te	テ
nocrop	ノクロップ
canonphotography	カノン写真
vidasaudavel	ビダサデベル
jordans	ジョーダン
carsofinstagram	carsofinstagram
balmain	バーマン
filmisnotdead	映画はありません
bling	ブリング
optoutside	オプトアウト
tennis	テニス
soundcloud	サウンドクラウド
nationaldogday	ナショナルドッグデー
taswanita	タスワニータ
lush	豊かな
british	イギリス人
closeup	閉じる
flashback	フラッシュバック
learning	学習
rings	リング
store	格納
mybabies	私の赤ちゃん
trekking	トレッキング
cod	タラ
bath	浴
gn	gn
cuteness	かわいらしさ
myhome	私の家
barbershopconnect	バーバーショップコネクト
ootdindo	ウッディンドー
inspirationalquotes	インスピレーションの言葉
rcnocrop	rcnocrop
semfiltro	semfiltro
gaypride	ゲイプライド
t	t
bracelets	ブレスレット
bridesmaids	花嫁介添人
cap	キャップ
sephora	セフォラ
souvenir	お土産
moschino	モチノ
day1	1日目
jk	jk
newjersey	ニュージャージー
24	24
mallorca	マヨルカ島
german	ドイツ人
workshop	ワークショップ
warsaw	ワルシャワ
palmtrees	ヤシの木
bakery	ベーカリー
motivationalquotes	モチベーションクォート
uni	ユニ
vino	ヴィーノ
deco	デコ
action	アクション
weightwatchers	重量計
lighting	点灯
hightimes	ハイウェイ
instagrammer	インストラクター
dairyfree	乳製品なし
4x4	4x4
shoppingonline	オンラインショッピング
room	ルーム
niceday	ナイセイ
writersofinstagram	作家の事例
lovethis	これが大好き
primos	プリモス
yogalove	ヨガロブ
u	あなた
photoofday	photoofday
vaping	授乳
kuliner	クライナー
gdragon	グドラゴン
teacher	先生
пп	пп
driving	運転
aniyakala	アニヤカラ
shorts	ショートパンツ
tiger	虎
science	科学
mascara	マスカラ
lisboa	リスボア
motivate	動機づける
myloves	私の愛
airmax	エアマックス
felicidade	フェリシダ
mickeymouse	ミッキーマウス
mcdonalds	マクドナルド
sugar	シュガー
panda	パンダ
sewing	縫い
entertainment	娯楽
philadelphia	フィラデルフィア
patekphilippe	パテックフィリップ
academia	学界
michigan	ミシガン
gel	ゲル
gratidao	グラチダオ
phuket	プーケット
r	r
cps	cps
murmer	殺人者
rogervivier	奉仕者
unitedkingdom	イギリス
socks	靴下
coconut	ココナッツ
tascewek	タセウェク
backstage	舞台裏
rooftop	屋上
hijabsyari	ヒジャブヤリ
suzuki	スズキ
may	かもしれない
happytime	幸せな時間
slammed	スラム
promote	促進する
arquitectura	建築家
cielo	シエロ
instagramanet	図鑑
ugly	醜い
alegria	アレグリア
danisnotonfire	ダニノントファイヤー
growth	成長
mensphysique	精神分裂病
con	コン
boring	退屈な
amazingphil	素晴らしい
bisexual	バイセクシュアル
11	11
jaket	ジャケット
backpacker	バックパッカー
landscape_lovers	landscape_lovers
milk	ミルク
blessings	祝福
redvelvet	赤いベルベット
beachday	ビーチデイ
dancers	ダンサー
drinking	飲酒
bearded	ひげそり
wrestling	レスリング
joker	ジョーカー
addicted	中毒
bliss	至福
shot	ショット
firenze	フィレンツェ
florence	フィレンツェ
slime	スライム
welcome	ようこそ
bordercollie	ボーダーコリー
gd	gd
highschool	高校
livethelittlethings	生命倫理
letsgosomewhere	どこかに行きましょう
modernsalon	モダンシオン
homedesign	ホームデザイン
shoeporn	ショーポーン
f52grams	f52グラム
селфи	селфи
freestyle	フリースタイル
nom	ノーム
makingmemories	メモリを作る
comida	コミダ
skatelife	スケートライフ
deep	深い
pursuepretty	追求する
perth	パース
feminism	フェミニズム
late	遅く
delhi	デリー
booklover	ブックオーバー
behindthechair	後ろの椅子
caribbean	カリブ海
early	早い
reunion	再会
turkiye	トルコイ
sohappy	とても幸せ
makeuptutorial	メイクアップチュートリアル
lion	ライオン
strongnotskinny	強盗
hairdo	髪型
sonne	ゾンネ
smart	スマート
happydays	幸せな日々
havingfun	〜を持っていた
luhan	ルハン
meuamor	ムアモア
summer2015	夏2015
amg	アム
ootdshare	ootdshare
mansbestfriend	男の親友
dia	ダイア
beef	牛肉
girlsgeneration	少女時代
солнце	солнце
teamwork	チームワーク
reebok	リーボック
village	村
bodrum	ボドルム
sqn	sqn
selfmade	自作
shadows	影
sales	販売
lp	lp
international	国際
девушка	девушка
vapestagram	vapestagram
tumblrboy	tumblrboy
stancenation	失踪
musicvideo	ミュージックビデオ
likeforlikeback	likeforlikeback
discover	発見
sorry	ごめんなさい
millionaire	富豪
broken	壊れた
olshopbandung	オルストバンドン
h	h
instatags4likes	instatags4likes
instasky	インスパイア
nailsofinstagram	ネームインスタントグラフ
greentea	緑茶
nyx	ニューヨーク
meat	お肉
bogor	ボゴール
drift	ドリフト
couplegoals	カップルの目標
doglove	ドグローブ
hkonlineshop	hkonlineshop
indirim	インドリム
from	から
maryjane	メリージェーン
egg	卵
createcommune	createcommune
superjunior	スーパージュニア
confidence	信頼
ship	船
vs	対
mybestfriend	マイフェストフレンド
jualbajumurah	ジュバルバムムラ
backpack	バックパック
instacar	インストラクター
jw	jw
blancpain	ブランパン
champions	チャンピオン
cancun	カンクン
field	フィールド
lost	失われた
pugsofinstagram	pugsofinstagram
mural	壁画
brandname	ブランド名
sakura	さくら
fslc	fslc
beards	ひげ
bloggers	ブロガー
gracias	グラシアス
pinup	ピンナップ
promosi	プロモーション
henna	ヘンナ
aroundtheworld	世界中で
photowall	フォトウォール
justme	私だけ
pale	淡い
犬	犬
apparel	衣服
prince	王子
exploreindonesia	エクスプロージョンインディア
cleaneats	クレーネ
soup	スープ
latenight	深夜
tequila	テキーラ
weloveshopping	ウェルビーエスケープ
traveldiaries	旅行記
beat	ビート
instafriends	instafriends
feelings	感情
aboutlastnight	aboutlastnight
crew	クルー
adana	アダナ
chelsea	チェルシー
bostonterrier	bostonterrier
madewithlove	愛を込めて作られ
flight	フライト
zumba	ズンバ
lindas	リンダ
nj	nj
thecreatorclass	thecreatorclass
minsk	ミンスク
cutebaby	かわいい赤ちゃん
19	19
spicy	スパイシー
redbull	レッドブル
icon	アイコン
songwriter	ソングライター
bieber	ビーバー
jumpsuit	ジャンプスーツ
recipe	レシピ
canvas	キャンバス
iphone6s	iphone6s
sotrue	仰るとおり
namjoon	ナムジュン
belleza	ベレーサ
bubbles	泡
shoot2kill	shoot2kill
ganja	ガンジャ
gayman	ゲイマン
elegance	優雅
sempre	センパー
vapor	蒸気
animallovers	アニマルオーバース
loves	愛する
camp	キャンプ
lonelyplanet	ロンリープラネット
justin	ジャスティン
iphone7	iphone7
sardegna	サルデーニャ
see	見る
vacations	休暇
day2	2日目
mychemicalromance	筋化学
southbeach	南のビーチ
f	f
homecooking	家庭料理
embroidery	刺繍
universe	宇宙
lonely	寂しい
texture	テクスチャ
virginhair	バージンヘア
instagramcats	instagramcats
april	4月
knowledge	知識
праздник	праздник
glow	輝き
import	インポート
feelgood	いい感じ
12	12
huffpostgram	ハーフポストグラム
cocacola	コカコーラ
traveladdict	旅行代理店
jersey	ジャージー
myprincess	踏み台
friyay	フリエイ
frankfurt	フランクフルト
wheels	車輪
mercedesbenz	メルセデスベンツ
results	結果
dibujo	ディブジョ
happybirthdaytome	happybirthdaytome
13	13
amour	アモール
atx	atx
iyigeceler	アイギクラー
transgender	トランスジェンダー
minime	ミニメ
vegaspromoter	ベガススピロモーター
iklan	イクラン
memory	記憶
belieber	信者
why	なぜ
fact	事実
wolf	狼
dogsofinstgram	dogsofinstgram
album	アルバム
aloha	アロハ
fml	fml
underground	地下
atardecer	atardecer
realshit	真実
makeupforever	makeupforever
shout	叫ぶ
vegasbaby	ベガスの赤ちゃん
eyelashes	睫毛
mandala	曼荼羅
maracaibo	マラカイボ
bkk	bkk
vegasbound	ベガスバウンド
tarz	タルツ
drone	無人機
comfy	心地よい
ig_masterpiece	ig_masterpiece
bully	いじめ
faded	退色した
prewedding	プリウェディング
jualmurah	ユルモンラ
contemporary	コンテンポラリー
happyme	ハッピーアム
happybaby	幸せな赤ちゃん
bouquet	花束
instaweather	インスタジャー
cruise	クルーズ
thc	THC
lastday	昨日
kebaya	ケバヤ
日本	日本
jualtasmurah	ユルタマスムラ
she	彼女
15	15
ig_japan	ig_japan
worldcaptures	ワールドカップ
bahia	バヒア
wce	傷
gtav	GTA V
august	8月
saintpetersburg	セントピーターズバーグ
kosmetik	コスメティック
hoodie	パーカー
avengers	アベンジャーズ
pleasecomment	コメントしてください
mindfulness	思いやり
dinnertime	夕食の時間
babyfashion	ベビーファッション
fe	フェ
zombie	ゾンビ
o	o
lab	研究室
onthetable	onthetable
makassar	マカッサル
newlook	ニュービュー
gothic	ゴシック
weekendvibes	週末のビデオ
edinburgh	エジンバラ
weddingplanner	ウェディングプランナー
mylook	私のスタイル
motocross	モトクロス
guess	推測
drama	ドラマ
nowplaying	再生中
caseiphone	カセイホン
charity	慈善団体
textpost	テキストポスト
bloom	咲く
jaketmurah	ジャケットムラ
figure	数字
beleza	ベレーサ
highlights	ハイライト
portraitpage	ポートレートページ
victoria	ビクトリア
handlettering	手書き
mcr	mcr
instabest	不安定な
turismo	ツリスモ
lisbon	リスボン
yoongi	汝矣島
funtime	楽しい時間
cats_of_instagram	cats_of_instagram
supplierbaju	サプライヤーバジャー
falloutboy	フォールアウトボーイ
im	イム
nickiminaj	ニッキー・ミナージュ
tacos	タコス
skiing	スキー
fans	ファン
purpose	目的
more	もっと
diesel	ディーゼル
everything	すべて
makeupbyme	メイクアップ
bossbabe	ボスベイ
noche	ノチェ
beyou	あなた
spirit	精神
ilove	私は愛してる
accesorios	アクセサリー
bir	バール
grandma	おばあちゃん
minhavida	ミニハビダ
relatable	関連性のある
smiling	笑う
centralpark	中央公園
hot_shotz	hot_shotz
cutedog	Cutedog
dubstep	ダブステップ
barbie	バービー
bucketlist	バケットリスト
clutch	クラッチ
equality	平等
tylerjoseph	タイラージョセフ
lookingforph	lookingforph
lotd	ロット
arab	アラブ
small	小さい
prayer	祈り
bridesmaid	花嫁介添人
newarrivals	新着
eu	EU
friendsforever	永遠の友達
heatercentral	ヒーターセントラル
bebek	ベベック
makeportraits	メイク
amizade	アメリカン
travelphoto	旅行写真
grace	猶予
mk	mk
yaoi	ヤオイ
el	エル
gnaydn	gnaydn
follow4followback	follow4followback
dogslife	犬の生活
workfromhome	在宅勤務
tatted	タトゥー
year	年
girlswithpiercings	ガールズウィスパーピアス
pdx	pdx
выходные	выходные
cartagena	カルタヘナ
mickey	ミッキー
flowersofinstagram	flowersofinstagram
lgbtq	lgbtq
bblogger	bblogger
panicatthedisco	パナッカーディスコ
instacats	instacats
bow	弓
wdywt	wdywt
fitnessfreak	フィットネス
100likes	100種類の
dtla	dtla
pr	pr
familyfun	家族での楽しみ
новыйгод	новыйгод
cookie	クッキー
wallart	ウォールアート
stickers	ステッカー
pout	拍手
teenwolf	ティーンウルフ
straighthair	真っ直ぐな髪
blueskies	ブルーススキー
oilpainting	油絵
lovefood	食べ物が好き
phone	電話
celana	セラナ
ilovehim	私は、彼を愛しています
igersfrance	igersfrance
govegan	ゴベガン
travellife	トラベリフェ
anorexia	食欲不振
cena	シエナ
need	必要
braid	編組
oslo	オスロ
chevrolet	シボレー
wod	ワッド
monkey	モンキー
technology	技術
bh	BH
male	男性
summerfun	サマーフン
batikmurah	バティック・ムラ
cash	現金
box	ボックス
gypsy	ジプシー
athens	アテネ
landscapes	風景
tiamo	ティアモ
quotestoliveby	quotestoliveby
kanyewest	カニエ・ウェスト
modelo	モデル
selfportrait	自画像
likeforfollowers	likeforfollowers
kosmetikmurah	コスメティクラ
25	25
tagstagramers	タグステーブル
italianfood	イタリア料理
bros	ブロス
sicilia	シチリア
snowday	雪の日
kendalljenner	ケンドールジェナー
hazza	ハザ
donuts	ドーナツ
poet	詩人
nofilters	nofilters
tasimportmurah	tasimportmurah
trail	トレイル
gsd	gsd
vscofood	vscofood
отпуск	отпуск
washingtondc	ワシントンDC
character	キャラクター
disco	ディスコ
maltese	マルタ語
july	7月
grosirtas	グロリアス
catalunya	カタルーニャ
supercars	スーパーカー
heat	熱
workhardplayhard	仕事の面白さ
bcn	bcn
hungary	ハンガリー
createexplore	createexplore
oreo	オレオ
contest	コンテスト
ben	ベン
venezia	ベネチア
volleyball	バレーボール
englishbulldog	イングリッシュブルドッグ
pastry	ペストリー
wonderwoman	ワンダーウーマン
foodlovers	食べもの
gaylove	ゲイロブ
mint	ミント
wealth	富
vanilla	バニラ
babiesofinstagram	子供の姿
fantastic	素晴らしい
detail	詳細
irish	アイルランド語
supportlocal	サポートするローカル
stage	ステージ
prettygirl	かわいい女の子
wax	ワックス
bodyart	ボディーアート
flowerpower	花の力
priceless	貴重な
сочи	сочи
sweetdreams	良い夢を
supplier	サプライヤー
notd	notd
caturday	猫の日
motivational	意欲的な
pelangsing	ペランギング
urlaub	ウルラブ
elf	エルフ
fitnesslife	フィットネスライフ
dab	ダブ
wind	風
canon_photos	canon_photos
picofday	ピコフデイ
deniz	デニズ
corgi	コーギー
short	ショート
polska	ポルスカ
yeg	イエグ
cutting	切断
cosplayer	コスプレイヤー
knit	ニット
truck	トラック
sundaymorning	日曜日の朝
shoponline	オンラインで買い物します
foundation	財団
saudades	サウダード
greatday	素晴らしい日
travelpics	旅行写真
ig_today	ig_today
deanwinchester	ディーンウィンチェスター
promotion	プロモーション
tokyoghoul	tokyoghoul
marathon	マラソン
hubby	夫婦
rideordie	乗り物
followbackalways	フォローバック
amici	アミチ
baltimore	ボルチモア
grosirbaju	グロッシバジュ
lifeisbeautiful	人生は素晴らしい
primeshots	プライムシュート
bathroom	バスルーム
igersmanila	イゲルスマニヤ
hearts	心
ネイル	ネイル
boa	ボア
your	きみの
currentlywearing	現在着ている
inkedup	インクアップ
czechgirl	チェスガール
ronaldo	ロナルド
spirituality	精神性
jeddah	ジッダ
hkshop	hkshop
bnw_captures	bnw_captures
sailing	セーリング
espresso	エスプレッソ
ig_mood	ig_mood
dslr	DSLR
never	決して
dragon	ドラゴン
cross	クロス
kimnamjoon	キムナンジューン
spn	スピン
hipstamatic	股関節
cr7	cr7
coffeeaddict	コーヒーアディクト
joshdun	ジョシュダン
pantip	パンティップ
gymflow	ジムフロー
jewels	宝石
owl	フクロウ
accessory	アクセサリー
riding	ライディング
luxo	ルクソ
ramen	ラーメン
kittensofinstagram	猫の姿勢図
fnaf	fnaf
natgeotravel	natgeotravel
bus	バス
resellerwelcome	再販業者
squadgoals	部隊のゴール
captainamerica	キャプテン・アメリカ
soleil	ソレイユ
leaf	葉
loved	愛された
crystal	結晶
baku	バクー
livelife	生きる
lovelovelove	愛愛愛
pineapple	パイナップル
keepgoing	立ち止まるな
aquarium	水族館
pleaseshoutout	喜んでいる
construction	建設
imissyou	あなたがいなくて寂しいです
dogsitting	犬ぞり
again	再び
rugby	ラグビー
library	としょうかん
tradition	伝統
slingbag	スリングバッグ
videos	ビデオ
flow	フロー
batam	バタム
experience	経験
deadlift	デッドリフト
farmlife	農業
amormaior	アモニアイア
дизайн	дизайн
instablog	instablog
giyim	ギィム
macqueen	マクキーン
oil	油
swagg	かわいそう
coaching	コーチング
newhair	新しい髪
backtoschool	学校に戻る
dailypic	デイ仕様
equestrian	乗馬
leggings	レギンス
focused	集中した
c	c
pony	ポニー
meal	お食事
suppliertas	Suppiertas
fslcback	fslcback
danhowell	ダンハウエル
flash	フラッシュ
казань	казань
thinking	考え
triathlon	トライアスロン
salute	敬礼
inkedgirls	インクドッグ
swagger	揺さぶる
neverforget	決して忘れない
ad	広告
cumpleaos	cumpleaos
allshots_	すべてのショット_
jackrussell	ジャックルセル
countrylife	田舎暮らし
favourite	お気に入り
tennessee	テネシー州
spongebob	スポンジボブ
cutiepie	かわい子ちゃん
landscape_captures	landscape_captures
followforfollowback	フォローフォローバック
crafts	工芸品
doodles	落書き
okinawa	沖縄
доброеутро	доброеутро
galatasaray	ガラタサライ
kimseokjin	キムソクジン
друзья	друзья
childhoodunplugged	子供のころ
only	のみ
bowling	ボーリング
shabbychic	馬小屋
kobe	神戸
shibainu	柴犬
damn	くそー
gq	gq
photoaday	フォト・ロード
teamfslcback	teamfslcback
fooddiary	食堂
animation	アニメーション
seventeen	17
itunes	itunes
gf_daily	gf_daily
ontario	オンタリオ
graffitiart	グラフィティアート
pugs	パグ
beatiful	美しい
airjordan	エアジョーダン
june	六月
buddha	仏
sunnydays	晴れの日
fullmoon	フルムーン
tanning	日焼け
snowboard	スノーボード
subway	地下鉄
calisthenics	体操
witch	魔女
phoenix	フェニックス
vscobest	vscobest
forever21	forever21
igsg	igsg
relaxation	リラクゼーション
ideas	アイデア
tomato	トマト
goodmood	良い雰囲気
iloveher	私は彼女を愛している
destiny	運命
learn	学ぶ
browneyes	茶色の目
gameday	ゲームの日
alaska	アラスカ
before	前
prima	プリマ
coast	海岸
bonjour	ボンジュール
weedporn	ウィードポール
popart	ポップアート
небо	небо
kyungsoo	キョンス
boo	ブー
lovestory	ラブストーリー
macros	マクロ
limitededition	限定版
bc	紀元前
instaweatherpro	instaweatherpro
woodworking	木工
kombin	コンビン
rainy	雨の
ladygaga	レディー・ガガ
beijing	北京
relationships	関係
worldcup	ワールドカップ
dontbullymybreed	dontbullymybreed
phillester	フィスター
days	日々
behindthescenes	背後にある
getaway	逃げる
goodbye	さようなら
fatalframes	肥満
friendshipgoals	友情目標
dmv	dmv
superbowl	スーパーボール
kalimantan	カリマンタン
ランチ	ランチ
march	行進
nodaysoff	休みなし
winterwonderland	冬のワンダーランド
cutekidsclub	cutekidsclub
зож	зож
photographylovers	撮影オーバー
ghost	幽霊
tatil	タチル
determined	決定
queer	奇妙な
shawnmendes	ショーネンデス
空	空
kitap	合宿
djlife	DJライフ
ca	ca
havefun	楽しむ
text	テキスト
thor	トール
kris	クリス
camo	カモ
dankmeme	ダンクミーム
kittycat	ネコちゃん
horsesofinstagram	馬の事例
lovepuppies	ラブプピッピー
nailporn	ネイルポリン
margarita	マルガリータ
киев	киев
religion	宗教
christianlouboutin	クリスチャンルブタン
fashiondaily	ファッション・デイリー
gg	gg
trailrunning	トレイルランニング
bespoke	別注
allnatural	オールナチュラル
globetrotter	グローブトロッター
ipad	ipad
funnyshit	ファニーニット
guitarist	ギタリスト
fatloss	肥満
winteriscoming	ウィンターシーズン
babybump	ベビーバンプ
mix	ミックス
lovemydog	ラブマイグ
wallpaper	壁紙
g	g
trippy	トリッピー
tramonto	トランモント
ourplanetdaily	毎日
платье	платье
curry	カレー
nz	nz
architectureporn	architectureporn
picnic	ピクニック
maquillaje	マキヤージ
aussie	オージー
animallover	アニマルラバー
instavape	インスタレーション
tagsforlikesfslc	tagsforlikesfslc
catlove	キャットローブ
opi	オピ
lunes	砂丘
sadness	悲しみ
eurotrip	ユーロトリプル
tasfashion	タスファッション
smh	smh
delivery	配達
ily	イリー
analog	アナログ
instabook	インスパイア
pc	pc
poledance	ポールダンス
highfashion	ハイファッション
portraitmood	ポートレートムード
porto	ポルト
momentos	瞬間
かわいい	かわいい
barranquilla	バランキヤ
unhas	unhas
watermelon	スイカ
bb	bb
kadounik	カドゥニク
maine	メイン
keepcalm	冷静さを保つ
bambam	バンバン
darkness	闇
but	しかし
mlb	mlb
remix	リミックス
lip	リップ
2k17	2k17
simplicity	単純さ
boats	ボート
livingroom	リビングルーム
wedges	厚切りポテト
cardigan	カーディガン
suicidal	自殺
recent	最近
coffeeshop	コー__ヒーショップ
likesforfollow	好きなものをフォローする
sportscar	スポーツカー
getinmybelly	getinmybelly
clubsocial	クラブソーシャル
professional	専門家
visitmyig	visitmyig
poolparty	プールパーティー
naples	ナポリ
architect	建築家
boda	ボダ
twinning	双子
w	w
straight	まっすぐ
beirut	ベイルート
snake	ヘビ
pinterest	pinterest
blues	ブルース
styleblog	スタイルブログ
deer	鹿
16	16
plur	複数
cuddle	抱きしめる
elephant	象
brazilian	ブラジル人
botanical	植物性
dios	ジオス
tarde	遅れ
neymar	ネイマール
shape	形状
pobkk	ポブック
sightseeing	観光
itworks	できます
sundays	日曜日
wales	ウェールズ
новосибирск	новосибирск
boost	ブースト
instaplace	instaplace
full	満員
skyscraper	超高層ビル
noir	ノワール
sandwich	サンドイッチ
instaitalia	始まり
blackandwhitephoto	黒と白の写真
shrimp	エビ
ma	マ
travelbug	トラベルバッグ
media	メディア
mark	マーク
chest	胸
bnw_life	bnw_life
spor	胞子
countdown	カウントダウン
shiny	輝く
acoustic	音響
luxe	ラックス
da	ダ
floweroftheday	流出期
menfashion	メンズファッション
санктпетербург	санктпетербург
christmaseve	クリスマス・イブ
biker	バイカー
missing	行方不明
teatro	テアトロ
runners	ランナー
wanderer	放浪者
highquality	高品質
puglia	プーリア
stuttgart	シュトゥットガルト
flatshoes	ぺたんこ靴
hospital	病院
bnw_society	bnw_society
parents	親
afterlight	アフターライト
puremichigan	純粋なミシガン
gaymen	ゲイメン
photogram	フォトグラム
sevilla	セビリア
natureaddict	自然愛好家
bijoux	ビジュアル
fifthharmony	五番目の調和
watercolour	水彩
poster	ポスター
mc	mc
nikerunning	ニッケンニング
beers	ビール
buonanotte	ブナナット
instagramjapan	インストゥルメンタル
belarus	ベラルーシ
linkinbio	リンクインビオ
latteart	ラテアート
kickboxing	キックボクシング
choker	チョーカー
gamergirl	gamergirl
bestofvsco	bestofvsco
birkin	バーキン
letsdothis	これをやろう
happysaturday	幸せな日
yorkshire	ヨークシャー
set	セット
goldcoast	ゴールドコースト
yogachallenge	ヨガチャレンジ
oneofakind	唯一無二
fashiondesign	ファッションデザイン
nyfw	nyfw
chanelboy	シャネルボーイ
bomb	爆弾
low	低い
yogalife	ヨーガライフ
bekasi	ベカシ
familyday	家族の日
proudmom	誇り
voyage	航海
whiskey	ウィスキー
charlotte	シャーロット
core	コア
pakistan	パキスタン
attitude	姿勢
lchf	lchf
lazyday	怠惰な一日
hakkasan	ハッカサン
photoart	フォトアート
911	911
ktm	ktm
gastronomia	食欲
toddlerlife	幼児の生活
littlemix	少し混ぜる
jensenackles	紳士服
fallfashion	秋のファッション
_	_
yumm	ヤム
memesdaily	memesdaily
papa	パパ
maui	マウイ島
gun	銃
tech	ハイテク
tattooedgirls	タトゥードガールズ
stupid	愚か
florist	花屋
sisterlove	妹の愛
fslcalways	fslcalways
tattoolife	タトゥーリーフ
collegelife	大学生活
sound	音
police	警察
slim	スリム
superhero	スーパーヒーロー
еда	еда
hairsalon	美容院
tequiero	テキエエロ
abandoned	放棄された
girlsnightout	ガールズナイトアウト
lyon	リヨン
travelawesome	旅行者
teamnatural	チームナチュラル
fitchicks	フィッチ
rockstar	ロックスター
khimar	キマー
myman	私の男
shoe	靴
earlybird	早乙女
ceramics	セラミックス
cyprus	キプロス
are	は
dontcare	ドントケア
made	製
ilovemyfollowers	私はフォロワーさんが大好きです
polaroid	ポラロイド
bohochic	ボホク語
female	女性
buy	購入
duck	アヒル
instawedding	インスタレーション
tower	タワー
onlineshopmurah	オンラインショップムラ
ninja	忍者
blur	ぼかし
bathtime	バスタイム
обувь	обувь
instafoto	イスタンブール
swiss	スイス
jammurah	ジャンムラ
jalanjalan	ジャランヤラン
swuk	スウク
pure	ピュア
tiuteam	ティートゥーム
tiny	小さな
danandphil	ダナンピル
instahome	イスタンブール
highlight	ハイライト
vancity	活力
vscophoto	vscophoto
k	k
solocosebelle	ソロコセベル
yogagirl	ヨーガガール
advertising	広告
sanantonio	サンタントーニオ
nationalsiblingday	国民の誕生日
colores	コロア
srilanka	スリランカ
beautifull	美しい
dompet	独占
production	製造
callofduty	コール・オブ・デューティ
maldives	モルディブ
tasbrandedmurah	tasbrandedmurah
tatoo	タトゥー
diving	ダイビング
fromwhereistand	fromwhereistand
salvador	サルバドール
off	オフ
civic	シビック
wallet	財布
tips	ヒント
hound	猟犬
mytinyatlas	mytinyatlas
mustache	口ひげ
bajuwanita	バジュワニータ
yumyum	ユミウム
harley	ハーレー
cutecat	かわいいねこ
royalsnappingartists	ロイヤルアスパート
postthepeople	ポスト・ピープル
happyfathersday	happyfathersday
украина	украина
dubsmash	ダブスマッシュ
harleyquinn	ハーレーキン
olympus	オリンパス
amei	アメ
superstar	スーパースター
pittsburgh	ピッツバーグ
entrepreneurs	起業家
mmm	うーん
stayandwander	stayandwander
instapets	霊長類
treat	治療する
cheer	応援
pencildrawing	ペイントドローイング
photobooth	プリクラ
emirates	エミレーツ
youtubers	youtubers
avgeek	avgeek
toryburch	トリーバーチ
nails2inspire	ネイルズ2世
happydog	ハッピードッグ
trainer	トレーナー
recuerdos	リュエルドス
premium	プレミアム
sg	sg
papafranku	パパフランク
vision	ビジョン
swimsuit	水着
yg	yg
estilodevida	エステロデビダ
stoned	ストーンズ
tenerife	テネリフェ
дом	дом
visualsgang	ビジュアルギャング
brunei	ブルネイ
vapedaily	vapedaily
batiksolo	バティックソロ
amazon	アマゾン
reunited	再会された
wholefoods	全食品
branded	ブランドの
geometric	幾何学的
bleach	漂白
twd	twd
v8	v8
santamonica	サンタモニカ
losamo	ロサモ
instanusantara	インスタントサンタラ
ejuice	エージス
lecker	レッカー
boomerang	ブーメラン
drummer	ドラマー
tuscany	トスカーナ
war	戦争
kek	ケック
feel	感じる
metro	地下鉄
different	異なる
lanadelrey	ラナ・デル・レイ
lovewins	愛情
architecturephotography	建築写真
foot	足
hermoso	ヘルモソ
goodvibesonly	おはようございます
ambition	野心
海	海
contour	輪郭
posing	ポーズ
uglyfollowtrain	醜いフォローイング
bikes	自転車
castiel	カスティーリャ
carnival	カーニバル
mancrushmonday	マンカルサイド
que	キュー
review	レビュー
kelly	ケリー
sucesso	スセソ
shotaward	ショットアワード
styleoftheday	styleoftheday
easy	簡単
loyalty	忠誠
them	それら
fighter	ファイター
igfit	igfit
salsa	サルサ
geometry	ジオメトリ
nurse	ナース
have	持ってる
gray	グレー
bloggerstyle	ブロガースタイル
bestvacations	ベストプラクティス
soft	柔らかい
pinkhair	ピンクヘア
casemurah	カセムラ
onlinestore	オンラインストア
happyness	幸せ
прогулка	прогулка
bigboy	大きい男の子
celanamurah	セラナムラ
resort	リゾート
hands	手
trickortreat	トリック・オア・トリート
brotherhood	兄弟愛
hayatakarken	ハヤタカカン
hangout	たむろう
sayajualonline	エサワロンオンライン
jualdress	ジュールドレス
gzel	ゲゼル
magical	魔法の
firsthand	直接
message	メッセージ
couples	カップル
beautifulgirl	美少女
tampa	タンパ
14	14
gaylife	ゲイライフ
moonlight	月光
flowerslovers	花冠
get	取得する
alien	エイリアン
jungle	ジャングル
gtr	gtr
30	30
goodeats	良い
narutoshippuden	ナルト疾風伝
bbloggers	bbloggers
muitoamor	夢のような
mug	マグ
ночь	ночь
cultura	文化
instamessage	インスタントメッセージ
viagem	バイエルン
turkinstagram	トルコの図
ootdhijab	ウットヒハブ
keto	ケト
greens	グリーン
happyplace	幸せな場所
soulmate	ソウルメイト
samwinchester	サムウィンチェスター
victoriassecret	ヴィクトリアズ・シークレット
путешествие	путешествие
graff	グラフ
sparkles	輝き
northcarolina	ノースカロライナ州
faces	顔
maedemenina	マデネナ
yogainspiration	ヨンインスピレーション
dragonballz	ドラゴンボールZ
paintings	絵画
reality	現実
pikachu	ピカチュウ
turquoise	ターコイズ
dogsofinstaworld	dogsofinstaworld
order	注文
catlife	キャットライフ
nialler	ナイアール
tascantik	タスカンティク
jualantas	ジュリアンタス
realtor	不動産業者
hund	ハンド
sincity	罪市
fotd	fotd
happyvalentinesday	happyvalentinesday
leadership	リーダーシップ
duckface	ダックフェイス
shoutouter	外出
f1	f1
oldtown	旧市街
succulents	多肉植物
spooky	不気味な
secondhand	中古
ballislife	ボールは人生
bonding	ボンディング
whatiworetoday	何とか
studying	勉強する
brighton	ブライトン
cup	カップ
cleveland	クリーブランド
olaplex	オラプレックス
worship	崇拝
turkishfollowers	ターキーフォロワーズ
beerporn	ビールポラン
tistheseason	ティシュシーズン
arms	武器
jualanbaju	フアランバジュ
realfood	リアルフード
na	ナ
mushrooms	きのこ
花	花
mummy	ミイラ
kdrama	Kdrama
that	それ
timeflies	タイムフライ
musicislife	音楽は人生だ
decoracao	デコラチャオ
shinee	シャイニー
hijaber	ヒジャーバー
iphone5s	iphone5s
blazer	ブレザー
naturegram	Naturegram
spider	クモ
bodypositive	陽性
goa	行きます
mr	氏
kemejamurah	ケメジャムラ
virginia	バージニア
helsinki	ヘルシンキ
sc	sc
trans	トランス
dompetmurah	ドンペトムラ
hug	抱擁
loving	愛する
angels	天使
jack	ジャック
womenswear	レディースウェア
j	j
much	たくさん
девушки	девушки
jackson	ジャクソン
sneakernews	スニーカーニューズ
iphone7plus	iphone7plus
katespade	ケイト・スペード
addiction	中毒
instagoodmyphoto	instagoodmyphoto
muse	ミューズ
almaty	アルマトイ
enjoying	楽しんで
strongwomen	強い女
sherlock	シェリル
supplements	サプリメント
loud	大声で
batikmodern	バティックモダン
warrior	戦士
cambodia	カンボジア
brownhair	茶髪
bluehair	青い髪
todaysoutfit	今日の衣装
eiffeltower	エッフェル塔
travelstoke	トラベルストーク
rare	まれな
adidasoriginals	アジダシリギナル
n	n
imagine	想像する
laughter	笑い
michaeljackson	マイケルジャクソン
fade	フェード
instacake	インストラクション
blacknwhite	ブラック・ホワイト
cappuccino	カプチーノ
beardlife	ビアーズライフ
beads	ビーズ
fighting	戦う
kado	かド
summernights	夏の夜
herbal	ハーブ
crazycatlady	狂牛病
bibliophile	羊毛嚢
countrygirl	カントリーガール
verde	ヴェルデ
breathe	呼吸する
vacay	休暇
wordporn	ワードポン
longboard	ロングボード
am	午前
pansexual	パノラマ
lovemyfamily	私の家族を愛し
door	ドア
streets	通り
feriado	フェリアード
allsmiles	全員
dbz	dbz
fabric	ファブリック
casio	カシオ
vibe	バイブ
smoking	喫煙
newyearseve	大晦日
asics	アシックス
longexposure	長時間露光
glasgow	グラスゴー
overwatch	オーバーウォッチ
bajuhijab	バジャヒヤブ
aceh	アチェ
cherry	チェリー
sticker	ステッカー
instalovers	インスタレーション
photographie	写真家
perfectday	完璧な日
january	1月
mujer	ムジェー
infinity	無限
candidchildhood	結婚した
youth	若者
peanutbutter	ピーナッツバター
image	画像
tee	ティー
dji	ジジ
stop	やめる
congratulations	おめでとう
doggie	犬
blackwhite	黒、白
longweekend	ロングウィーク
powder	パウダー
catering	ケータリング
sabah	サバ
istanbuldayasam	イスタンブールデーダム
popcorn	ポップコーン
wordsofwisdom	知恵の言葉
noodles	麺
wish	望む
traffic	トラフィック
brussels	ブリュッセル
olshopjkt	olshopjkt
google	google
katyperry	ケイティー・ペリー
married	既婚
whynot	何故なの
start	開始
djs	DJs
amodemais	amodemais
odessa	オデッサ
slimmingworldjourney	スリミングワールド・ツーリズム
contrast	コントラスト
successful	成功した
foodforthought	思考の糧
funnypictures	funnypictures
nailsoftheday	今すぐ
otp	otp
septum	中隔
movement	移動
chillout	冷静になる
soexcited	すみません
freetime	自由時間
shout_out	大声で叫ぶ
batikindonesia	バティックインディアネシア
myfavorite	お気に入り
happyweekend	ハッピーウィーク
fatty	脂肪
weddingideas	結婚式
lux	ルクス
minnesota	ミネソタ州
goodafternoon	こんにちは
instarunners	instarunners
cerveza	セベザ
feelinggood	いい感じがする
dessertporn	デッサーポリ
mall	モール
東京	東京
february	2月
sneakerheads	スニーカーヘッド
bajubangkok	バジャンブゴク
viaje	ビェイェ
guatemala	グアテマラ
макияж	макияж
di	ジ
jualansist	ジュリアン主義者
videooftheday	videooftheday
yogaeverywhere	yogaeverywhere
spinach	ほうれん草
staypositive	依頼主義的
yogini	ヨーギニ
852	852
afro	アフロ
likeforme	likeforme
noiva	ノーヴァ
sepatuwanita	セパワニタ
coco	ココ
4chan	4chan
ed	エド
ig_exquisite	ig_exquisite
primas	プリマ
pedicure	ペディキュア
goodevening	こんばんは
hayat	ハヤット
elbise	エルフ
dressup	着飾る
sevgi	セビギ
mywork	私の仕事
longisland	ロングアイランド
dont	いけない
selenator	セレネーター
don	ドン
care	お手入れ
mybirthday	私の誕生日
flag	フラグ
amigo	アミーゴ
russian	ロシア
aov	aov
pie	パイ
way	方法
socialmediamarketing	ソーシャルメディアマーケティング
vsconature	vsconature
statue	像
pearl	パール
azerbaijan	アゼルバイジャン
京都	京都
sonyalpha	ソニーアルファ
goat	ヤギ
modellife	モデリフ
afterwork	仕事の後
lombok	ロンボク島
cosy	居心地の良い
bohostyle	ボホイル
luv	ルーヴ
hairfashion	ヘアファッション
ilovemakeup	ilovemakeup
aniversario	アンバサリオ
veggie	野菜
redcarpet	レッドカーペット
turtle	カメ
senior	上級
caf	カフェ
homecoming	帰郷
fashionhijab	ファッションヒザブ
earthpix	アースピックス
showroom	ショールーム
mycat	私の猫
flowermagic	フローマラギック
1direction	1方向
handpainted	手塗り
brownie	ブラウニー
cotton	コットン
gig	ギグ
edsheeran	エド・シーラン
oops	おっとっと
wholesale	卸売
movienight	映画の夜
toes	つま先
syari	シャリ
karaoke	カラオケ
vespa	ベスパ
spotify	見分ける
bob	ボブ
fur	毛皮
ugh	ugh
bordeaux	ボルドー
couponcommunity	クーポンコミュニティ
cologne	コロンヌ
familylove	家族愛
smtown	smtown
dude	おい
shisha	シシャ
loveme	私を愛して
used	中古
natale	ナターレ
safari	サファリ
social	ソーシャル
olshopsurabaya	オルソプラバヤ
woof	横糸
swimmingpool	スイミングプール
wander	さまよう
michael	マイケル
author	著者
workoutmotivation	運動失調症
students	学生の
macrophotography	マクロ写真
barista	バリスタ
oahu	オアフ
hats	帽子
xbox360	xbox360
atasan	アタサン
amazingcars247	amazingcars247
directioners	指揮官
amoremio	アモレミオ
az	az
weareone	Weareone
ouch	灰色
teeth	歯
foodart	フードアーツ
nighttime	夜間
novidades	ノビダデス
beautifulview	美しい景色
bestwoof	ベストウルフ
mtl	MT
bvb	bvb
styleinspiration	スタイルインスピレーション
yuri	ユリ
rustic	素朴な
believeinyourself	自分を信じて
bio	バイオ
norge	ノーゲ
hermanos	ヘルマナス
toypoodle	トイプードル
melody	メロディー
torino	トリノ
likeaboss	偉ぶって
festive	お祝い
siberianhusky	シベリアンハスキー
saat	サート
mentalhealth	メンタルヘルス
hometown	出身地
creation	創造
urbex	urbex
seokjin	ソクジン
5sosfam	5ソスファム
gelin	ゼラチン
2011	2011年
target	ターゲット
foodphoto	フードフォト
aksesoris	アケスリス
bom	ボム
businesswoman	実業家
tangerang	タンジェラン
beautyandthebeast	美女と野獣
ramadan	ラマダン
flowerporn	フラワーポン
вналичии	вналичии
igfood	igfood
human	人間
skypainters	スカイター
nevada	ネバダ
caramel	キャラメル
tagforlike	tagforlike
backyard	裏庭
acessorios	アセスリオス
photochallenge	フォトチャレンジ
noedit	ノーエディット
day3	3日目
newlife	新生活
records	記録
екатеринбург	екатеринбург
underwater	水中
frias	フリア
ilovecats	私は猫が大好き
malta	マルタ
corona	コロナ
archidaily	Archidaily
bn	bn
vampire	吸血鬼
marvelcomics	驚嘆
gmy	グミ
ccoo	クック
pesonaindonesia	ペソネインデルニア
aztagram	アズグラム
ハンドメイド	ハンドメイド
flexibility	柔軟性
oakland	オークランド
birmingham	バーミンガム
poser	ポーズ
waltdisneyworld	ウォルトディズニーワールド
redwine	赤ワイン
painter	画家
mj	mj
кот	кот
marseille	マルセイユ
lasvegasstrip	レーザーガスストリップ
eventos	イベント
filters	フィルター
table	表
alwaysfollowback	alwaysfollowback
fotos	写真
sketches	スケッチ
makeupoftheday	メイクアップデー
toyphotography	トヨタ写真
biz	ビズ
czechrepublic	チェコ共和国
stones	石
mybabygirl	mybabygirl
aliceinwonderland	不思議の国のアリス
mx	mx
vegasready	vegasready
nightphotography	夜景撮影
motorbike	バイク
trabalho	トラバルゴ
pinoy	ピンギー
leopard	ヒョウ
warriors	戦士
diseo	病人
coat	コート
handstand	逆立ち
nikeairmax	ナイキエアマックス
serenity	静寂
hulk	ハルク
deephouse	ディープ・ハウス
ростов	ростов
photographers	写真家
racecar	レースカー
chihuahuasofinstagram	チワワの姿
деньрождения	деньрождения
praha	プラハ
mishacollins	ミシャコリン
instasummer	instasummer
hairgoals	ヘアゴール
wien	ウィーン
foodstyling	食料品
mens	男性用
rottweiler	恋人
kahve	カーヴェ
final	最後の
walklikeus	歩くこと
montana	モンタナ
firsttime	初めて
hp	馬力
nirvana	涅槃
childrenphoto	子供の写真
minniemouse	ミニーマウス
decorations	装飾
selfi	セルフ
longdress	ロングドレス
triggered	トリガーされた
luke	ルーク
thaifood	タイ料理
mountainbike	マウンテンバイク
longbeach	長い砂浜
universalstudios	ユニバーサルスタジオ
allday	一日中
cine	シネ
europa	ユーロパ
cumple	占領
persian	ペルシア語
fierce	激しい
nc	NC
fries	フライドポテト
terrier	テリア
donaldtrump	ドナルド・トランプ
hotchocolate	ホットチョコレート
sunsetlovers	サンセットオーバー
vaporwave	蒸気波
snacks	スナック
selena	セレナ
blueberry	ブルーベリー
volentino	ボルチェノ
stay	滞在
sardinia	サルデーニャ
merida	メリダ
emotions	感情
instacars	インストラクター
mazda	マツダ
inspiring	感動的な
customcase	カスタムケース
rsa_nature	rsa_nature
cherryblossom	桜の花
instatattoo	インスタットトゥート
lindos	リンゴ
doggo	ドッグゴ
trustedonlineshop	トラステッドラインショップ
niggasbelike	niggasbelike
p	p
petals	花弁
vscoedit	vscoedit
pekanbaru	ペカンバル
noi	ノイ
beautyblog	美容ブログ
sochi	ソチ
dafbama2017	dafbama2017
ph	ph
minnie	ミニ
monaco	モナコ
tulips	チューリップ
massage	マッサージ
instadecor	instadecor
soap	石鹸
cornwall	コーンウォール
katze	カッツェ
og	OG
vscofilm	vscofilm
stairs	階段
kwt	kwt
think	思う
gelnail	ゲルネイル
track	トラック
dutch	オランダの
poolside	プールサイド
tomorrow	明日
recording	録音
cathedral	大聖堂
awesomeearth	素晴らしい
idea	アイディア
purplehair	紫色
bentley	ベンチュリー
repeat	繰り返す
hairoftheday	ハロフジディー
fcbarcelona	FCバルセロナ
azul	アズル
mxico	mxico
instaflower	インスタントフラワー
so4so	so4so
fitnessgoals	フィットネスゴール
boatardee	ボートダディー
olshopsolo	オルショーロ
reflections	反射
igfashion	igfashion
mommylife	ママイライフ
macarons	マカロン
tshirts	Tシャツ
sepatucowok	シーパクウォーク
goprooftheday	goproofthedayay
減肥	減量
jaredpadalecki	ジャレッドパダレッキ
lazysunday	lazysunday
instashoes	instashoes
discount	ディスカウント
penang	ペタン
gt	gt
instamama	インスマママ
buddy	バディ
frenchiesofinstagram	フランス語の説明
haveaniceday	良い一日を
prisma	プリマ
ohwell	しかたがない
bisnisonline	ビスニソンライン
explorer	冒険者
horsepower	馬力
magickingdom	魔法の王国
mobilemag	モバイルマッグ
perro	ペロ
photobomb	光爆弾
trabajo	トラバージョ
seasons	季節
clashofclans	クラッシュオブクラン
record	記録
жизнь	жизнь
sup	サポート
cerveja	セベハ
подарки	подарки
mce	マス
networking	ネットワーキング
crown	クラウン
с	с
girlsthatlift	ガールスタントリフト
santorini	サントリーニ
patience	忍耐
大阪	大阪
booknerd	booknerd
iphonecase	iphoneケース
igbabies	igbabies
regalo	レガロ
viajar	viajar
veganism	完全主義
somuchfun	とても楽しい
puravida	プラビダ
punkrock	パンク
weeaboo	ウィアブー
malibu	マリブ
polishgirls	ポリッシュガールズ
carireseller	キャリセラー
catsofig	catsofig
collagen	コラーゲン
balloons	風船
funinthesun	ファインインススン
poetsofinstagram	poetsofinstagram
sleepyhead	睡眠
maedemenino	マデネニノ
catlady	キャットリー
mobile	モバイル
закат	закат
paisaje	パサイア
max	最大
jualsepatumurah	ユルセパトムラ
parenting	子育て
bu	bu
taeyeon	テヨン
wifey	wifey
motivationmonday	動機づけ
supportsmallbusiness	サポートビジネス
billionaire	億万長者
independent	独立した
fb	fb
fender	フェンダー
tasransel	タッセル
edits	編集
laughs	笑う
omnia	オムニア
tags4likes	tags4likes
rs	rs
awareness	意識
hermesbirkin	ヘルメスバーキン
mersin	メルシン
pork	豚肉
pll	PLI
taskorea	タスクレア
entrepreneurlife	起業家生活
hautecouture	オートクチュール
jualcase	ユアケース
teddybear	テディベア
goodquality	良品質
chiangmai	チェンマイ
royal	ロイヤル
hood	フード
stretch	ストレッチ
pleasefollowme	私に従ってください
still	まだ
medicine	医学
lularoe	ルーラロー
sign	符号
myview	私の見解
papua	パプア
concept	概念
hogwarts	ホグワーツ
relaxed	リラックスした
gaystagram	gaystagram
foodshare	食糧援助
alberta	アルバータ州
he	彼
homework	宿題
в	×
whitagram	白い灰色
likesreturned	好きになった
hiit	ハイト
natureporn	自然環境
mirrorselfie	鏡
kimono	着物
bleachmyfilm	漂白剤フィルム
bestphoto	ベストフオト
shiba	芝
instakicks	インスタックス
outfits	服装
wilderness	荒野
boymom	ボイムーム
bw_lover	bw_lover
handmadewithlove	手作りの手袋
team_jp_	team_jp_
airforce	空軍
peach	桃
vegashost	ベガシュート
kindness	親切
sam	サム
eliquid	エリキッド
independenceday	独立記念日
nikontop	ニコント
app	アプリ
banjarmasin	バニャルマシン
soho	ソーホー
adopt	採用
gununkaresi	ガンカンレセイ
animeboy	アニメボーイ
worldplaces	ワールドプレース
nature_shooters	nature_shooters
nightclub	ナイトクラブ
foreveryoung	いつまでも若々しい
freezing	凍結
benz	ベンツ
gelpolish	ゲルポリッシュ
heritage	遺産
memorialday	記念日
instabeer	スタビエ
portraiture	肖像
trabzon	トラブゾン
barca	バルカ
camerondallas	キャメロンダラス
comeback	戻って
pontianak	ポンティアナク
essentialoils	エッセンシャルオイル
microblading	マイクロブレード
silence	沈黙
deadpool	デッドプール
drag	ドラッグ
flexibledieting	柔軟性
thanksgod	感謝祭
zurich	チューリッヒ
lovenature	細部
slovakia	スロバキア
y	y
clay	粘土
selfcare	セルフケア
londonlife	ロンドンの生活
newsong	新しい曲
pty	pty
gatos	ガトス
grill	グリル
carpediem	今を楽しめ
friendsforlife	friendsforlife
caffeine	カフェイン
happyfamily	幸せな家族
testimoni	証言
ilovefood	私は食べ物が大好き
tutorial	チュートリアル
flatlay	フラットレイ
kunst	クンスト
verao	ベラオ
homo	ホモ
kathniel	カスニエル
amomuitotudoisso	amomuitotudoisso
blancoynegro	ブランコネグロ
infinite	無限
ottawa	オタワ
mondays	月曜日
vote	投票
sandals	サンダル
metime	時制
dogscorner	ドッグスコナー
expo	エクスポ
pro	プロ
luz	ルーズ
livingthedream	夢を生きている
prayforparis	prayforparis
theme	テーマ
oldpic	古い写真
beliebers	信者
christmas2015	christmas2015
windows	窓
streetfood	屋台の食べ物
custommade	カスタムメイド
visit	訪問
koreanfood	韓国料理
lightroom	軽食
polskadziewczyna	ポリスカジューシキナ
landscapelovers	ランドスケープオーバー
jueves	ジュエーブ
sweatermurah	sweatermurah
recife	レシフェ
bud	芽
makeover	変身
bajuanakmurah	バジャナクラ
шеллак	шеллак
glutes	うずき
edgymemes	エッジミーム
staytuned	乞うご期待
chrisbrown	クリス・ブラウン
mexicocity	メキシコシティ
newengland	ニューイングランド
ありがとう	ありがとう
empire	帝国
lampung	ランプラン
led	LED
snuggles	くつろぎ
stronger	より強く
maryland	メアリランド
onlineshopindo	onlineshopindo
noite	ノワイト
darlingmovement	ダーリン運動
leagueoflegends	リーグ・オブ・レジェンズ
better	より良い
basic	基本的な
palace	宮殿
bologna	ボローニャ
martialarts	殉教者
ok	OK
sneakerporn	スニーカーポン
week	週間
chanelbag	シャネルバッグ
sacramento	サクラメント
bestrong	最強
50likes	50かかりつけ
shatter	粉砕する
yarn	糸
exoticcars	エキゾチックカー
karma	カルマ
newhome	ニューホーム
onpoint	オンポイント
personaltraining	パーソナルトレーニング
kiwi	キウイ
nigeria	ナイジェリア
bestmeow	ベスト
tehran	テヘラン
fav	fav
fuji	富士
pilot	パイロット
piercetheveil	ピアスシート
escape	エスケープ
lucu	ルク
гуляем	гуляем
weddingparty	結婚式のパーティー
bless	祝福
sofa	ソファー
вкусно	вкусно
queenp	女王
youcandoit	あなたの意見
ig_italia	ig_italia
nyxcosmetics	ナイクスコツ
mushroom	キノコ
weddingcake	ウエディングケーキ
gluta	グルタ
perfectbody	完璧なボディ
lifegoals	ライフゴール
eid	eid
gems	宝石類
selenators	セレネーター
comfortfood	食べるとホッとする料理
halal	ハラル
chillen	チレン
toscana	トスカーナ
si	シ
io	io
treats	扱う
theimaged	イメージされた
ayylmao	アイルーマ
phototag_it	phototag_it
newbeginnings	新たな始まり
mates	仲間
psychedelic	サイケデリック
hkiger	hkiger
shamelessselefie	恥知らずのセクシー
vegasclubs	ベガスクラブ
director	ディレクター
quran	quran
hurt	傷つける
kpopf4f	kpopf4f
dowhatyoulove	ダウハイウオーヴ
marina	マリーナ
vegasnights	vegasnights
vscocamphotos	vscocamphotos
florals	フレア
doctor	医師
likethis	このような
orangecounty	オレンジ
preloved	プリロードされた
saltlife	塩の生活
rosegold	ローズゴールド
flyfishing	フライフィッシング
mojito	モヒート
arsenal	アーセナル
slimmingworldfamily	スリミングワールドファミリー
tomatoes	トマト
thestruggle	闘争
herms	ヘルムズ
2k16	2k16
wisconsin	ウィスコンシン州
highway	ハイウェイ
mtv	MTV
cousinlove	いとこ
congrats	おめでとう
stress	応力
xs	xs
lowered	低下した
greek	ギリシャ語
engine	エンジン
loreal	恋人
labsofinstagram	labsofinstagram
bay	湾
vscofeature	vscofeature
mud	泥
amores	美人
minion	ミニオン
telaviv	テルアビブ
healthyhair	健康な髪
soback	ソーバック
darthvader	ダース・ベイダー
mornings	朝
cleanfood	クリーンフード
belle	ベル
ayakkabi	アヤカビ
frenchgirl	フランス人の女の子
tomlinson	トムリンソン
worthit	価値がある
ceo	最高経営責任者（CEO
happytummy	幸せな
animeart	アニメアート
sdv	SDV
literature	文献
scenic	風光明媚な
buzzfeast	バズフェスト
huffposttaste	ハッポステスト
alps	アルプス
wonderfulindonesia	すばらしいインドネシア
championsleague	チャンピオンズリーグ
taslucu	タスルキュ
blacklist	ブラックリスト
наращиваниересниц	наращиваниересниц
bajubayi	バジャーブイ
hairextensions	広がり
lexus	語彙
maternidade	母性
mommasboy	mommasboy
rico	リコ
brazilianhair	ブラジルヘアー
nationalpark	国立公園
goodluck	がんばろう
metalhead	メタルヘッド
squareinstapic	正方形の
allblack	全部黒
fotografheryerde	フォトグラファー
mad	怒っている
healthybreakfast	健康に良い
mukena	ムケナ
canadian	カナディアン
horan	ホーラン
its	その
lovewhatyoudo	あなたは何をすべきかを愛する
foodlove	フードクロス
vickteerut	ヴィッキーテット
crewlife	乗組員
selstagram	セルスタグラム
chips	チップ
tats	タッツ
l4f	l4f
latino	ラティーノ
next	次
gamiscantik	ゲームマッチ
un	国連
blooms	開花する
bahamas	バハマ
designs	デザイン
architexture	アーキテクチャテクスチャ
obatjerawat	オバツェラワット
discoverearth	ディスコヴェーバー
weheartit	私たちは心配します
presente	プレゼンテーション
coffe	コフ
humble	謙虚な
timelapse	タイムラプス
twice	二度
weedstagram420	weedstagram420
palermo	パレルモ
calgary	カルガリー
tat	タット
countrymusic	カントリーミュージック
lakelife	レイクライフ
eminem	エミネム
onlineshopjakarta	onlineshopjakarta
planner	プランナー
cockerspaniel	コスターズパネル
winetasting	ワイン試飲会
marykay	メアリーケイ
balikpapan	バリクパパン
warszawa	ワルシャワ
bench	ベンチ
sobackteam	ソバテアム
meditate	瞑想する
fotodeldia	フォトデルディア
greenday	グリーン・デイ
driver	ドライバ
poems	詩
growingup	育つ
aksesuar	アケスアール
фитнес	фитнес
lifted	持ち上げられた
photographyislifee	写真ライセンス
barba	バーバ
toofaced	顔を合わせる
spanish	スペイン語
fitnessfood	フィットネスフード
happybday	誕生日おめでとう
blackgirlsrock	blackgirlsrock
zamanidurdur	ザマニダールール
tp	tp
looks	外見
bridalmakeup	ブライダルメークアップ
complexkicks	コンプレックス
dreamteam	ドリームチーム
topshopthailand	トップショー
will	意志
igot7	igot7
explorebc	エクスプローラ
beverlyhills	ビバリーヒルズ
calvinklein	カルバンクライン
turkish	トルコ語
messy	厄介な
menwithstyle	menwithstyle
wrx	wrx
stayfit	stayfit
大好き	大好き
romania	ルーマニア
olshoptrusted	olshoptrusted
dreads	恐怖
leader	リーダー
hits	ヒット
pottery	陶器
sm	sm
gshock	gshock
lookup	見上げる
bridalshower	ブライダルシャワー
vestido	ヴェスティド
bbc	BBBC
foodisfuel	食糧燃料
lovekittens	ラブキッテン
ya	y A
whatever	なんでも
lategram	レイトグラム
rns	RNS
dayout	デイアウト
foodcoma	食べ物
fondant	フォンダン
handbags	ハンドバッグ
hills	丘
compassion	思いやり
eastcoast	東海岸
jadine	ジャディーヌ
mixtape	ミックステープ
daisy	デイジー
instamoda	インマモダ
lookingup	見上げる
casino	カジノ
circus	サーカス
industrial	工業用
lighthouse	灯台
cuisine	料理
streetlife	ストリートライフ
adelaide	アデレード
momswithcameras	momswithcameras
hermeskelly	ヘルメスケリ
sweetheart	恋人
interiordecor	インタビュアー
bruh	ブルフ
ipa	ipa
barquisimeto	バルセイメート
artlife	アートライフ
dontgiveup	あきらめてはいけない
hunter	ハンター
beanie	ビーニー
camaro	カマロ
sverige	Sverige
imagination	想像力
end	終わり
african	アフリカ人
freespirit	自由な精神
feminist	フェミニスト
cutest	かわいらしい
yogaeveryday	yogaeveryday
wig	かつら
nashgrier	ナシュジー
youngjae	若才
freeongkir	フリーンキル
фотосессия	фотосессия
courage	勇気
desayuno	デユユノ
cutenessoverload	cutenessoverload
sepatunike	Sepatunike
likesforlike	好きなもの
mixedmedia	ミックスメディア
fashiongirl	おしゃれな少女
mlg	mlg
hiend	元気に
jilbabmurah	ジルバブムラ
clubbing	クラブング
ladiesnight	女性の夜
bodygoals	体の目標
letthembelittle	Letthembelittle
yogurt	ヨーグルト
womeninbusiness	女性ビジネス
dragonball	ドラゴンボール
theoutbound	アウトバウンド
sorriso	ソリソ
syria	シリア
26	26
berries	ベリー
df	df
southkorea	サウスコレア
bigeyes	大きな目
btsarmy	Btsarmy
blessing	祝福
essie	エッセイ
gamers	ゲーマー
disneygram	ディズニーグラム
saudade	サウダード
padang	パタン
johncena	ジョン・シナ
plage	プラージュ
fashionmodel	ファッションモデル
die	死ぬ
fob	フォブ
cargram	手書き
totebag	トートバッグ
nailedit	ばっちり成功
itsmorefuninthephilippines	フィリピン人
hangover	二日酔い
leica	ライカ
instapict	黙示録
thegoodlife	良い生活
dedicated	専用
viral	ウイルス性の
louisiana	ルイジアナ
christmas2016	christmas2016
sti	スティ
tongue	舌
trance	トランス
murahbanget	ムラバンゲ
four	四
rotterdam	ロッテルダム
jayz	ジェイズ
villa	ヴィラ
summerdays	夏の日々
manila	マニラ
hype	誇大宣伝
carbs	炭水化物
bobmarley	ボブ・マーリー
pobangkok	ポーバンコク
hotd	ホット
pump	ポンプ
weddingmakeup	weddingmakeup
olshopindonesia	オルショーネインドネシア
filmmaking	映画制作
скидки	скидки
lawofattraction	引力の法則
brownies	ブラウニー
floripa	フロリパ
thank	感謝
coral	コーラル
chasinglight	追い焚き
rei1440project	rei1440project
dreamer	夢見る人
whisky	ウィスキー
makersgonnamake	メーカーの造形
violet	バイオレット
dominicanrepublic	ドミニカ共和国
gtaonline	gtaonline
series	シリーズ
prettylittleliars	プリティ・リトル・ライアーズ
gerardway	ジェラードウェイ
mydaughter	私の娘
cities	都市
2hand	二手
bajucouple	バズーカプル
icu_japan	icu_japan
nhl	NHL
hediyelik	ヘディリック
ducati	ドゥカティ
earlymorning	早朝
ficaadica	フィカディカ
mamasboy	ママズボイ
om	om
favoritesong	お気に入り
instafunny	instafunny
motor	モーター
quebec	ケベック州
fora	のために
crush	粉砕する
obama	オバマ
lounge	ラウンジ
puglove	パグロブ
socality	サクラリティ
featuremeinstagood	特集のテーマ
fitbit	フィットビット
taeyang	太陽
gatto	ガットー
на	на
godbless	神のご加護を
code	コード
inktober2017	インクトート2017
skills	スキル
unity	統一
headband	ヘッドバンド
camilacabello	カミラカベッロ
limited	限られた
おうちごはん	おうちごはん
旅行	旅行
mumlife	マムライフ
madeoffabric	Madeoffabric
twin	ツイン
kidsofinstagram	子供の姿勢図
veganlife	ビーガンライフ
bulgaria	ブルガリア
gin	ジン
gelato	ジェラート
tomford	トムフォード
poetrycommunity	詩人コミュニティー
flexible	フレキシブル
ombrehair	オンブル髪
enduro	エンデューロ
sleepingbeauty	眠れる森の美女
funk	ファンク
bristol	ブリストル
jeju	ジェジュ
фотограф	фотограф
aww	全員
instagreat	インスパイア
southamerica	南アメリカ
kw	kw
pig	豚
christ	キリスト
staffy	スタッフ
acting	演技
bowtie	ちょうネクタイ
recommended	お勧め
cloudchaser	クラウドチェイサー
wanita	ワニータ
broadway	ブロードウェイ
hey	ねえ
nigga	ダチ
mario	マリオ
arena	アリーナ
maternity	マタニティ
unitedstates	アメリカ
blackwork	ブラックワーク
lamp	ランプ
sunflower	ヒマワリ
豐胸	爆薬
mybabyboy	私の男の赤ちゃん
parfum	香水
cheap	安いです
stylegram	スタイルグラム
instafoodie	インスピレーション
times	回
kadoultah	カドゥルタ
coke	コークス
oakley	オークリー
cigar	葉巻
instagallery	instagallery
rio2016	rio2016
strand	鎖
wdw	wdw
tokyocameraclub	トキオカメラクラブ
munchies	ムンジー
interview	インタビュー
personal	個人的
hehe	ヘーヘ
cycle	サイクル
jualanonline	ジュアラノンライン
messyhair	ボサボサの髪
finditliveit	見つけた
радость	радость
pitbulls	ピットブルズ
silk	シルク
mutlu	ムムル
iphone4	iphone 4
animalsofinstagram	動物の姿勢図
день	день
meeting	会議
vscolove	vscolove
shore	海岸
uitm	uitm
topshelflife	トップシェリフ
igyoga	igyoga
vatanika	ヴァータニカ
pai	パイ
ve	ve
coachella	コーチェラ
killeverygram	キリバレグラム
yacht	ヨット
fortaleza	占星術
chair	椅子
takip	タキップ
dressyourface	ドレスユー
pashmina	パシュミナ
basket	バスケット
schnauzer	シュナウザー
моя	моя
static	静的
newcastle	ニューキャッスル
toofunny	面白すぎる
teddy	テディ
soproud	ソプラッド
bronx	ブロンクス
businessman	ビジネスマン
keep	キープ
pnwonderland	Pnwonderland
mik	ミーク
haircolour	髪の色
tvd	テレビ
cairo	カイロ
lluvia	ルビア
years	年
phandom	ファンダム
5k	5k
dancehall	ダンスホール
bosslady	ボスレディ
positividade	ポジティブディバイド
hairdye	毛髪染料
proudmommy	誇らしげな
thestruggleisreal	ザ・シュートラグリス
slingbagmurah	スリングバグムラ
traditionaltattoo	伝統的なタトゥー
niver	ナイバー
comidadeverdade	comidadeverdade
goku	おとぎ
cards	カード
сумки	сумки
b612	b612
bodybuildingmotivation	ボディービル運動
traveldeeper	旅行者
stpatricksday	聖パトリックの日
vacationtime	休暇
fds	fds
gang	ギャング
shoulders	肩
postworkout	ポストワークアウト
usj	usj
wildlifephotography	野生動物写真
bier	ビール
windy	風が強い
lash	ラッシュ
konya	コンヤ
sulawesi	スラウェシ島
weirdo	奇妙な
celebrations	お祝い
giftideas	ギフト
babyshop	ベビーショップ
finnishgirl	フィンニッシュガール
alice	アリス
mg	mg
bookish	予約する
rok	ロク
2010	2010年
weddingphoto	結婚式の写真
pot	ポット
consciousness	意識
bee	蜂
risas	リサ
hairofinstagram	ハイロフイスラム
nikah	ニカ
bringmethehorizon	地平線を見せてくれ
manchesterunited	マンチェスター・ユナイテッド
unconditionallove	無条件の愛
bd	bd
influencer	インフルエンサー
iraq	イラク
nosleep	全く寝ていない
hungergames	ハンガル
bokeh	ボケ
pearls	真珠
brides	花嫁
pepe	ペペ
bestday	いい日
dreamcatcher	ドリームキャッチャー
m3	m3
grande	グランデ
insect	昆虫
madness	狂気
pt	pt
whole30	全体30
mclaren	マクレーン
south	南
mompreneur	卒業生
nailsalon	ネイルサロン
дизайнногтей	дизайннггеей
kazan	カザン
storyofmylife	私の人生談
lateupload	lateupload
fuckyou	ファニオウ
самара	самара
foodoftheday	食べ物
tatts	タット
kookie	クッキー
z	z
50mm	50mm
se	セ
photographyislife	写真ライフ
labradorretriever	ラブラドール・レトリバー
divergent	発散する
bars	バー
tfl	tfl
sepatukeren	シーパケーン
helpme	助けて
fenerbahe	fenerbahe
futebol	フートボール
flor	フロア
instagold	instagold
coldplay	コールドプレイ
sbado	サバド
30likes	30件
saigon	サイゴン
hanoi	ハノイ
kacamata	カカマタ
ifollow	私はついていきます
homegrown	自家製
samarinda	サマリンダ
bigbrother	ビッグブラザー
flexfriday	フレックスフライ
freshair	新鮮な空気
dailyphoto	毎日の写真
lovethissong	この曲が大好き
rebel	反逆の
ww	ww
mami	マミ
beautifulplace	美しい場所
mediterranean	地中海
instapics	イスタンブール
dr	ドクター
feels	感じる
lacoste	ラコステ
powerful	強力な
пляж	пляж
photographysouls	写真魂
mitsubishi	ミツビシ
fotografie	写真
chinatown	チャイナタウン
descanso	descanso
eatwell	よく食べる
heavymetal	重金属
fountain	噴水
culinary	料理
larryisreal	狼男
aot	aot
extensions	拡張
gymshark	ジムシャーク
glassofig	glassofig
blackandgrey	ブラックアンドグレイ
diskon	ディスコン
inverno	インヴェルノ
blacklab	ブラックラブ
rider	ライダー
ネコ	ネコ
createexploretakeover	createexploretakeover
updo	アップロード
explorecanada	エクスプロカナダ
dodgers	ドジャース
nars	ナーズ
hikingadventures	ハイキングアドベンチャー
lemonade	レモネード
master_shots	マスターショット
pom	ポン
followplease	フォローアップ
lowlife	低生活
shake	振る
endorse	支持する
gayteen	ガイテン
ballerina	バレリーナ
legit	正当な
weddingdecor	結婚式のディナー
brasilia	ブラジリア
nationalpuppyday	全国消費者
instatalent	瞬間的
genderfluid	ジェンダー流体
torta	トルタ
kentucky	ケンタッキー州
preworkout	プレワークアウト
carlifestyle	カーリフスタイル
clear	クリア
armcandy	武装
boxersofinstagram	ボックスのインスタンス
luxurycars	豪華な車
designers	デザイナー
chinesefood	中華料理
mani	マニ
naturehippys	自然のヒッピー
thebeatles	ビートルズ
lagos	ラゴス
fine	細かい
snowman	雪だるま
hijabi	ヒジャビ
mio	ミオ
come	来る
malaga	マラガ
blackbutler	黒執事
dog_features	dog_features
vladivostok	ウラジオストク
adidassuperstar	adidassuperstar
wedgesmurah	ウェッジェラ
masti	マスティ
снег	снег
instagirls	インスギャル
инстамама	инстамама
madonna	マドンナ
__	__
forkyeah	フォークイヤー
nailsart	nailsart
kathrynbernardo	kathrynbernardo
midnight	真夜中
fashionillustration	ファッションイラストレーション
primo	プリモ
cebu	セブ
inshot	コメント
sepatubandung	シーパンバンドン
goprohero4	ゴプロロ4
modamasculina	modamasculina
nationalbestfriendday	国民の親友
fashionstylist	ファッションスタジスト
fcb	fcb
xd	xd
paws	足
decoracion	デコラティブ
olshopjogja	オルソジョグジャ
homestyle	自家製
incredibleindia	信じられないほどの
littlegirl	littlegirl
bonfire	焚き火
30tododia	30トドニア
мама	мама
two	二
refreshing	さわやかな
interiordesigner	インテリアデザイナー
maybelline	メイベリン
losingweight	体重を減らす
deathnote	デスノート
photographyeveryday	イメージ毎日
shawl	ショール
desenho	デスセンホ
pordosol	ポードソール
kazakhstan	カザフスタン
instafamily	instafamily
uncle	叔父
buddies	仲間
bestnatureshot	bestnatureshot
littlesister	リトリースター
onlineshopindonesia	オンラインホップインディシア
дом2	дом2
bmth	bmth
like4likeback	like4likeback
leeds	リーディング
summer2014	2014年夏
onlineboutique	オンラインブティック
idk	idk
mexicanfood	メキシコ料理
queensland	クイーンズランド州
exhausted	疲れた
belanja	ベランジャ
wear	着る
elsa	エルサ
sassy	生意気
voice	音声
patd	パット
vsco_hub	vsco_hub
bootcamp	ブートキャンプ
payne	ペイン
夏	夏
ディズニー	ディズニー
_	_
omnomnom	オムノムノム
curvygirl	curvygirl
interiorstyling	インテリアスタイル
theater	劇場
positivethinking	前向きな思考
fatherandson	父と息子
allshotsturkey	allshotsturkey
monoart	モノアート
missingyou	あなたが恋しい
hd	HD
buendia	ブデンディア
mycity	私の街
flora	フローラ
girlswithink	girlswithink
rainydays	雨の日
pfw	pfw
kebayamodern	ケバヤモダン
oklahoma	オクラホマ
weekends	週末
maracay	マラカイ
jesuschrist	イエス・キリスト
subohm	サブオーム
urbanromantix	urbanromantix
newbornphotography	新生児撮影
birdsofinstagram	birdsofinstagram
therapy	治療
ファッション	ファッション
sleepingwithsirens	眠っている間
chanelclassic	シャネルクラシック
fuckit	愚か者
sade	サード
click	クリック
card	カード
ciao	チャオ
runhappy	走る
ikon	イコン
folk	フォーク
type	タイプ
blackveilbrides	黒いベールの花嫁たち
topmodel	トップモデル
santacruz	サンタクルーズ
destiel	デスティル
welivetoexplore	ウェルビーエキステック
strangerthings	見知らぬ人
underarmour	下着
dontjudgeme	勝手に決めつけないで
wool	ウール
motivacion	モチベーション
tu	タウ
interiores	インタリオ
美白	美白
bello	ベロ
weightlossmotivation	体重減少
muitoamorenvolvido	Muitoamorenvolvido
gayhot	gayhot
seungri	昇竜
fearless	恐れる
pumpkins	カボチャ
ariel	アリエル
ig_italy	ig_italy
bitchesbelike	愚痴
weddingseason	結婚式
coffeebreak	コーヒーブレーク
port	ポート
школа	школа
toast	トースト
город	город
burgers	ハンバーガー
fourthofjuly	7月4日
eatlocal	食べる
bachelorette	独身者
tagsforfollow	タグのフォロー
openreseller	オープンリセラー
base	ベース
carinstagram	風刺漫画
laurenjauregui	ロレンジャーレギュ
musicians	ミュージシャン
curitiba	クリチバ
yvr	yvr
fashionjewelry	ファッションジュエリー
rims	リム
missit	それを逃す
welltravelled	よく泳ぐ
knittersofinstagram	編み手の事例
olsun	オルソン
gloss	光沢
bugatti	バガッティ
danielpadilla	ダニエルパディージャ
atwork	職場で
mivida	ミーダ
belanjaonline	ベランジャーライン
instagram_kids	instagram_kids
malik	マリク
familie	家族
edrecovery	エドリカバリー
bartender	バーテンダー
indonesian	インドネシア語
gain	利得
allstar	オールスター
kl	KL
cantstopwontstop	cantstopwontstop
vector	ベクター
mainecoon	メインクーン
noregrets	ノレグレット
session	セッション
lookslikefilm	ルックスフィーム
motorsport	モータースポーツ
weight	重量
kale	ケール
jerawat	ジェラート
bayern	バイエルン
station	駅
socialenvy	ソーシャルエンジニア
incredible	信じられない
memphis	メンフィス
justsaying	ただ言って
ilovedogs	犬が大好き
gogreen	ゴーイング
earring	イヤリング
finals	決勝
crying	泣く
matcha	抹茶
vita	ヴィータ
cowboys	カウボーイズ
cachorro	カチョロ
vscoonly	vscoonly
fossil	化石
beerstagram	ビール
asexual	無性的な
dialindo	ダイヤリンド
пятница	пятница
instaclick	インスタントリック
characterdesign	キャラクターデザイン
cry	泣く
softball	ソフトボール
bows	弓
moi	モイ
winelover	ウィンターオーバー
astana	アスタナ
marble	大理石
modelling	モデリング
adobe	アドビ
lobster	ロブスター
mnchen	ミンヘン
awsome	awsome
bake	焼く
talented	才能のある
photoshooting	写真撮影
instayoga	インスタントヨガ
worklife	ワークライフ
levis	リーバイス
newday	新しい日
lunchbox	弁当箱
retail	小売
uruguay	ウルグアイ
sugarfree	シュガーフリー
gayfollow	ゲイフォロー
shingekinokyojin	進撃の巨人
desi	デシ
famille	ファルミユ
arista	アルスター
spaghetti	スパゲッティ
company	会社
instadesign	instadesign
too	あまりにも
instacoffee	インスタントコーヒー
bloggerlife	ブロガーライフ
fake	偽
blu	ブルー
eyelashextensions	眼掛け
hairideas	髪の毛
vegansofinstagram	完全な姿勢
graphicdesigner	グラフィックデザイナー
artistsofinstagram	artistsofinstagram
mmj	mmj
werk	ワーカー
blueberries	ブルーベリー
coc	コック
tatuaje	タトゥアエ
instavsco	instavsco
breathtaking	息を呑む
batikpekalongan	バティックペカロンガン
dragqueen	ドラッグクイーン
oneday	ある日
reallife	実生活
grosirsepatu	グロッシスパパ
coordinate	座標
myfav	お気に入り
pemutih	ペムティフ
sigueme	シグマ
missher	彼女に会いたい
sepatuadidas	Sepatuadidas
whitening	ホワイトニング
blackpink	ブラックピンク
kedi	ケディ
sgig	sgig
alternativegirl	オルタナティヴガール
ishootfilm	ishootfilm
lima	リマ
sampa	サンパ
waffles	ワッフル
destinationwedding	行き先
bemestar	ベームスター
frame	フレーム
eos	エオス
ducks	アヒル
fisheye	魚眼レンズ
prettygirls	可愛い女の子
croptop	腹腔鏡
parceria	パーセリア
raspberry	ラズベリー
raining	雨
cinderella	シンデレラ
reptile	爬虫類
electro	エレクトロ
muah	ムア
potato	じゃがいも
kalung	カリン
carshow	カーショー
marrakech	マラケシュ
awesomeness	素晴らしい
pemutihwajah	ペムティワワ
pole	ポール
evil	悪の
surfer	サーファー
fx	FX
key	キー
weddingplanning	ウェディングプランニング
blizzard	猛吹雪
rockandroll	ロックンロール
hotwheels	ホットウィール
herbst	ハーバスト
vegaslife	ベガスライフ
planneraddict	プランナーアクト
gaintrain	ゲイントレイン
lotus	蓮
noel	ノエル
makeupmurah	メイクアップ
lavender	ラベンダー
open	開いた
lakers	レイカーズ
veganfoodporn	ビーガンフードポン
gelang	ゼラング
beutiful	美しい
eatcleantraindirty	食欲不振
aldc	aldc
es	es
krasnodar	クラスノダール
honeyme	ハネム
or	または
protectivestyles	保護主義
st	セント
goldendoodle	ゴールドエンドードル
onceuponatime	昔々
monochromatic	単色
knife	ナイフ
brendonurie	ブレンドゥンジュリー
seniors	先輩
right	右
weightlosstransformation	体重変化
instaparty	instaparty
dachshundsofinstagram	dachshundsofinstagram
liftheavy	リフトヘビー
treatyoself	treatyoself
blackisbeautiful	黒人美人
blush	赤面
prints	プリント
tuning	チューニング
jualtasbranded	jualtasbranded
uniqlo	ユニクロ
cd	CD
paseo	パセオ
vamos	ヴァモス
girlfriends	ガールフレンド
proudmama	誇らしげな
zombies	ゾンビ
kpopl4l	kpopl4l
dentist	歯科医
casesamsung	ケースサムスン
psn	psn
невеста	невеста
goofy	グーフィー
instajewelry	インストゥルメンタル
tomorrowland	明日の国
bekind	ベカンド
letsgetit	できるだけ早く
very	非常に
makeupartistsworldwide	メイドアップパートナーズワールドワイド
haircare	ヘアケア
gemstone	宝石
secret	秘密
juventus	ユベントス
kainbatik	カインバティック
sinfiltros	sinfiltros
farmersmarket	農家市場
lord	主
greatness	偉大
dvd	DVD
gramoftheday	文法的に
rockstargames	ロックスターズ
dolls	人形
americanmuscle	アメリカの筋
27	27
path	パス
bug	バグ
bushdid911	bushdid911
bebold	大胆になります
littlebrother	リトルブラザー
waterfalls	滝
puntacana	プンタカナ
alltimelow	オールティームローウ
listen	聴く
yaz	ヤズ
sd	SD
skulls	頭蓋骨
wordstoliveby	wordstoliveby
kindergarten	幼稚園
ctfu	ctfu
shark	鮫
chubby	ふわふわした
succulent	多肉植物
goingout	外出
shopaholic	ショッピングハリウッド
tunikmurah	tunikmurah
urbanandstreet	urbanandstreet
roamtheplanet	ローミングプラネット
filho	フィリョ
awake	起きている
yorkshireterrier	ヨークシャーテリア
matte	マット
winners	勝者
worldstar	ワールドスター
worldtraveler	世界旅行者
garlic	ニンニク
plussizefashion	plussizefashion
nepal	ネパール
xmen	エックスメン
setlife	セットライフ
acrylicpainting	アクリルペインティング
jualanbro	ジャワンブロ
jamtangancewek	ジャムタンガンスワック
hamster	ハムスター
feliznavidad	フェリズナビダード
afternoontea	アフタヌーンティー
longday	長い一日
tuna	ツナ
eatingdisorder	摂食障害
vl	vl
vapelove	vapelove
miam	マイアム
metallica	メタリカ
pendant	ペンダント
decorao	デコラオ
pancake	パンケーキ
thirsty	渇いた
дача	дача
swedish	スウェーデンの
armenia	アルメニア
service	サービス
amoreterno	永遠の愛
vintagefashion	ヴィンテージファッション
summer17	夏17
sailormoon	セーラームーン
illust	イラスト
theglobewanderer	グロブワンダラー
junior	ジュニア
businessowner	事業主
gigihadid	ギジハディド
enjoyinglife	人生を楽しむ
tabby	タブビー
trucks	トラック
stonernation	ストーンネーション
可愛い	可愛い
legends	伝説
красноярск	красноярск
funnight	おやすみなさい
interior4all	interior4all
fair	フェア
makeupmafia	メイクアップマフィア
special_shots	特別写真
身	身
accesories	アクセサリー
vscolife	vscolife
withlove	愛を込めて
suppliermurah	Suppiermurah
sahm	サーム
batikcouple	バティックカップル
futsal	フットサル
lebron	レブロン
like4tags	like4tags
tattedup	タテアップ
corn	コーン
guyswithtattoos	みんなと一緒に
menshair	メンヘア
spraypaint	スプレーペイント
fashioninspo	ファッションインポ
auckland	オークランド
zebra	シマウマ
hkseller	HKSeller
cowboy	カウボーイ
wonderland	ワンダーランド
и	и
asos	アソス
skies	空
myfriend	私の友人
martes	マート
earthfocus	アースフォーカス
ariana	アリアナ
алматы	алматы
makyaj	マクヤジ
instasantiago	事務所
makeupgeek	メイクアップゲーク
barkbox	バークボックス
marilynmonroe	マリリンモンロー
burn	燃やす
haikyuu	俳句
barbersinctv	野蛮人
cinematography	映画撮影
loveisintheair	ラブ・イズ・イン・ザ・エア
bestsong	最高の歌
yogapose	ヨーガポーズ
igersvenezuela	igersvenezuela
taste	味
fitnessgear	フィットネスギア
ig_photooftheday	ig_photooftheday
yugyeom	ユギョム
saludable	説得力のある
alabama	アラバマ州
decorating	飾る
electronic	電子
_	_
formatura	フォーマット
devil	悪魔
fandoms	ファンディーム
puppygram	子犬の贈り物
nights	夜間
somethingboudoir	何かの屋台
jewelrygram	ジュエリーグラム
instaturkey	インスパイアキー
hola	ホア
dawn	夜明け
americansalon	アメリカ人
southcarolina	サウスカロライナ
bookaddict	書店
suppliersepatu	サプライヤーペパトゥ
852shop	852shop
australianshepherd	オーストラリア人ヘップド
toystory	トイ・ストーリー
sono	ソノ
punjabi	パンジャブ
recycle	リサイクル
supplierbajumurah	サプライヤーバジュムラ
stories	物語
igshopmalaysia	igshopmalaysia
hardrock	ハードロック
dreaming	夢
garmin	ガーミン
tokyodisneyland	トキソディニルと
seeaustralia	Seeaustralia
antiaging	老化防止
walkingdead	生ける屍
правильноепитание	правильноепитание
motorcycles	オートバイ
volgoitalia	volgoitalia
weddinghair	ウェディングヘア
riverside	川岸
loveyourbody	愛しい人
politics	政治
rawfood	生物
bestdayever	史上最高の日
furbabies	おとぎ話
beachbum	砂浜
bundles	バンドル
manama	マナマ
madebyme	製作
gown	ガウン
newmexico	ニューメキシコ
familytrip	家族旅行
poesia	ポエジア
films	映画
ace	エース
shoegame	ショーメ
pa	PA
likeitup	likeitup
victory	勝利
handbagmurah	ハンドバッグムラ
tie	ネクタイ
астана	астана
cinnamon	シナモン
instamag	インスタント
documentary	ドキュメンタリー
mae	マエ
timessquare	タイムズスクエア
jualjamtangan	ジュリアンタンガン
likeforliketeam	likeforliketeam
moodoftheday	moodoftheday
halloweenmakeup	halloweenmakeup
weshouldsmoke	weshouldsmoke
player	プレーヤー
partyhard	パーティー
playoffs	プレーオフ
cheatday	おやすみ
younique	ユニーク
patisserie	パティスリー
dogofinstagram	dogofinstagram
va	バ
karate	空手
newin	ニューイング
engineering	エンジニアリング
showtime	ショータイム
scared	怖い
pictoftheday	pictoftheday
bulldogs	ブルドッグ
motogp	モトグ
sundown	日没
discipline	規律
nmd	nmd
gunaydin	ガンデイン
aircraft	航空機
healthyeats	健康
sisterhood	姉妹
indiana	インディアナ
thevampirediaries	ヴァンパイア・ダイアリー
cristiano	クリスティアーノ
hijabootd	ヒジャブート
patriots	愛国者
maroc	マロク
50	50
spacer	スペーサー
yummyinmytummy	おいしいミートミー
anne	アニー
newarrival	新参者
interior123	interior123
ios	アイオス
keepitwild	KeepitWild
arabic	アラビア語
sone	息子
bulldogsofinstagram	ブルドッグソフラム
amistad	アミスタッド
sonrisa	ソリリサ
extreme	極端な
dan	ダン
triceps	三頭筋
videogame	テレビゲーム
studiolife	スタビオライフ
thegreatoutdoors	thegreatoutdoors
destination	先
kln	KLN
q8instagram	q8インスタンス
localbrand	ローカルブランド
verona	ヴェローナ
meencanta	メタンカンタ
bajucowok	バズコウォク
wfayo	wfayo
workinghard	懸命に働く
test	テスト
nap	昼寝
coupons	クーポン
comiccon	コミック
siberia	シベリア
yeni	円
down	ダウン
bape	ベイト
seashore	海岸
babymodel	ババイモデル
filmmaker	映画監督
southflorida	サウスフロロダ
одесса	одесса
popularpic	ポピュラーピクニック
vaper	ベーパー
melaka	メラカ
yummyfood	おいしいフード
hacked	ハッキングされた
regalos	レガロス
boeing	ボーイング
bigben	ビッグベン
biggirl	大きな女の子
barberlove	バーベロブ
colourpop	色彩ポップ
kacamatamurah	カカマタムラ
filipino	フィリピン
scruff	鋭い
ootdmagazine	オットーマガジン
greatdane	グレートデーン
meu	メウ
sunsetporn	サンセットポルン
senioryear	最終学年
взаимныелайки	взаимныелайки
podcast	ポッドキャスト
srs	srs
jackdaniels	ジャックダニエル
auntie	叔母
crafty	狡猾な
emogirl	emogirl
crossfitgirls	crossfitgirls
watchporn	watchporn
qualidadedevida	質保証
photosession	撮影会
corvette	コルベット
textposts	テキストポスト
meusamores	メサモア
garagesale	ガレージセール
sell	売る
kyiv	キブ
instaglam	スタジャラム
square	平方
ricordi	リコルダ
ig_turkey	ig_turkey
fab	ファブ
doxie	ドクシー
sepatuimport	sepatuimport
hadiah	ハディヤ
streetarteverywhere	streetarteverywhere
traditionalart	traditionalart
charleston	チャールストン
perlengkapanbayi	パーランカパンバイ
volunteer	ボランティア
минск	минск
miamor	マイアミ
studentlife	学生生活
markers	マーカー
kampanya	カンパニャ
weave	織る
cow	牛
artstagram	アート
baked	焼きました
umbrella	傘
saturdaymorning	土曜日の朝
fueledbythc	fueledbythc
daesung	大城
tapas	タパス
kfc	kfc
granada	グラナダ
depok	デポク
samsun	サムスン
fambam	ファムバム
kerudung	ケルダウン
highsnobiety	高音質
cannes	カンヌ
effyourbeautystandards	安心の手配
rva	rva
whathappensinvegas	べガスで何が起きてるの
visual	ビジュアル
pemutihbadan	ペムティバダン
fitforlife	fitforlife
riseandgrind	ライジングアンドグラインド
shibuya	渋谷区
sweethome	面白い
getit	それを得る
pier	桟橋
jewlery	酒宴
artesanato	アルテサナート
newfriends	新しい友達
fairy	妖精
loamo	ロアモ
suits	スーツ
tt	tt
cristianoronaldo	クリスチャンロナウド
writersofig	writersofig
harmony	調和
freeshipping	送料無料
mulher	モルダー
_	_
sundayvibes	サンデーバイブス
taptap	テントップ
rally	ラリー
cutepetclub	cutepetclub
vinylcollection	ビニルコレクション
euro	ユーロ
minha	ミンハ
photodaily	光で
vapehooligans	vapehooligans
buffet	ビュッフェ
superfood	スーパーフード
foodtruck	屋台
skeleton	スケルトン
charcoal	木炭
york	ヨーク
networkmarketing	ネットワークマーケティング
vegasvacation	vegasvacation
lviv	リヴィウ
urbanphotography	都市写真
really	本当に
cc	CC
pugstagram	pugstagram
vscobrasil	vscobrasil
vaporizer	気化器
fukuoka	福岡
all_sunsets	all_sunsets
ashton	アストン
ptv	ptv
arts_help	arts_help
insomnia	不眠症
teamcanon	チームカンカン
pond	池
bagged	袋詰
lokalah	ロカラ
ohana	オハナ
70s	70年代
jualmakeup	jualmakeup
lovingit	楽しんでます
yogapractice	ヨーグルト
31	31
boating	ボート
vapepics	動悸
spnfamily	スパンファミリー
girlsday	誕生日
yeezyboost	yeezyboost
happymoments	happymoments
huntgram	ハントグラム
lara	ララ
mkexplore	mkexplore
fashionwanita	ファッションウィニタ
cruising	クルージング
blunt	鈍い
bisnis	ビスニス
biking	自転車
eclipse	日食
luxurytravel	ラグジュアリートラベル
ecig	一口
universodamaquiagem_oficial	universodamaquiagem_oficial
cabelo	キャベロ
eventplanner	イベントプランナー
владивосток	владивосток
swing	スイング
kodak	コダック
iyi	イーイー
snoopy	スヌーピー
kardashian	カーダシアン
мы	мы
artisan	職人
moving	動く
minasgerais	ミナスゲレ
siblinglove	兄弟姉妹
makeithappen	実現させる
husbandandwife	夫婦
brave	勇敢な
junghoseok	ジョンョソク
rum	ラム
arianator	仲間
fashionbloggers	ファッションブロガー
head	頭
clock	クロック
bigsize	ビッグサイズ
chestday	チェストの日
gcc	gcc
fiance	婚約者
airsoft	エアソフト
acrylicnails	アクリルネイル
lola	ローラ
gardens	庭園
squirrel	リス
wheel	ホイール
stil	スティル
natureshots	本物
grandtheftauto	グランドセフトオート
hamburger	ハンバーガー
byebye	バイバイ
bestpic	ベストピクチャ
recipes	レシピ
explorejogja	explorejogja
mysister	私の姉
gaziantep	ガジアンテプ
babystyle	バビスタイル
sasuke	サスケ
instagramfitness	図鑑
digitalpainting	デジタルペインティング
shredz	シュレッツ
jeeplife	ジープライフ
спасибо	спасибо
hamilton	ハミルトン
venicebeach	ベニスビーチ
para	パラ
santaclaus	サンタクロース
hygge	ハイゲージ
hermana	ヘルマナ
workworkwork	仕事、仕事、仕事
going	行く
bw_photooftheday	bw_photooftheday
桜	桜
мск	мск
olympics	オリンピック
fear	恐れ
fikagrandeporra	フィカグランデポラ
bajukorea	バズコレア
denpasar	デンパサール
day4	4日目
nationalgeographic	ナショナル・ジオグラフィック
skating	スケート
moms	ママ
musik	ミュージカル
jualfollowers	jualfollowers
магазин	магазин
amorincondicional	アモリンキオン
sheep	羊
vscostyle	vscostyle
настроение	настроение
bretagne	ブルターニュ
double	ダブル
крым	крым
ragdoll	ラグドール
adele	アデル
animales	動物
pasion	歩
любимый	любимый
exam	試験
vapers	泣き虫
manzara	マンザラ
coffeegram	コーヒーグラム
cl	cl
lipgloss	リップグロス
foreveralone	いつまでも一人ぼっち
likebackalways	好きなバックウェイ
instatags	インスタット
dylanobrien	ジラノバレン
maxidress	マクドナルド
classiccar	クラシックカー
chitown	チャットタウン
usmc	usmc
bones	骨格
amiche	アミチェ
bullterrier	ブルテリア
xxl	xxl
dn	dn
halloweencostume	ハロウィンの衣装
誕生日	誕生日
delicioso	delicioso
suicidesquad	自殺幇助
stl	stl
lashextensions	老化
crete	クレテ
indotravellers	インドアトラベラー
blacklove	ブラックロブ
jogging	ジョギング
serious	深刻な
instaphotography	インスタント写真
dekorasyon	デカラション
bajumuslimah	バジュムスリマ
chocolates	チョコレート
oatmeal	オートミール
bronze	ブロンズ
olshopmedan	オルショーマン
softgrunge	ソフトグランジ
followmenow	従う
手作り	手作り
melaniemartinez	メラニマーティミネス
le	ル
chocolat	ショコラ
xo	xo
fitfamily	フィットファーリー
smiley	スマイリー
gettingready	準備中
winkwhite	ウィンクホワイト
quads	四肢
blogging	ブログ
palm	手のひら
tumblrpost	tumblrpost
matching	マッチング
snowwhite	白雪姫
milkshake	ミルクシェーク
livros	リヴロス
fitstagram	フィット図
stolen	盗まれた
listentothis	これを聞いてください
mlp	mlp
ash	灰
our	我々の
squishyfacecrew	かすかな面白い
marines	海兵
deporte	追放
evolution	進化
outfitinspiration	外見
ti	ティ
naturallight	自然光
kaftan	カフカン
scooter	スクーター
写真	写真
athome	家に
misshim	彼がいなくて寂しい
marbella	マルベージャ
jumper	ジャンパー
huge	巨大
gmc	gmc
myphoto	私の写真
wait	待つ
revolution	革命
жара	жара
cummins	カミンズ
jualkosmetik	ユルコスメティック
sk8	sk8
erkek	エルケク
cat_features	cat_features
beachwear	ビーチウェア
confident	自信を持って
menwithclass	メンズクラス
merry	メリー
followforlikes	followforlikes
taksim	タクシム
comfort	快適
sanjose	サンノゼ
girlswithmuscles	女子バスケットボール
grandpa	おじいちゃん
zelda	ゼルダ
tatuagem	タトゥアエム
brands	ブランド
funkopop	ファンクポップ
yup	うん
yummi	ヤミー
genre	ジャンル
amman	アンマン
pennsylvania	ペンシルベニア
vscoturkey	vscoturkey
bolo	ボロ
moustache	口ひげ
noivas	ノワバ
letters	手紙
manado	マナド
yoona	ユナ
costa	コスタ
_	_
heineken	ハイネケン
shirts	シャツ
bulking	バルキング
инстадети	инстадети
musculation	筋肉増強
vietnamese	ベトナム語
pit	ピット
親バカ部	親バカ部
instafollowers	イスタフォロワー
здоровье	здоровье
survivor	生存者
frenchies	フランス人
move	動く
keyif	キーフ
honolulu	ホノルル
inkedgirl	インクドッグ
serbia	セルビア
gymaddict	gymaddict
here	ここに
folkgood	フォーククッド
lucy	ルシー
igkiddies	igkiddies
happytimes	幸せな時間
roots	ルーツ
lifelessons	人生の教訓
wellbeing	ウェルビーイング
spiaggia	スパイアジア
foconadieta	フォコダエタ
pursuitofportraits	ポートレートの追求
salento	サレント
eyewear	アイウェア
flowerstalking	花ストーミング
birthdaygift	誕生日プレゼント
allblackeverything	オールブラックスのもの
canon_official	canon_official
chocolatecake	チョコケーキ
gayselfie	ゲイシー
los	ロス
iphone6plus	iphone6plus
tribal	部族
feathers	羽毛
уфа	уфа
theweeknd	ウィーク
livecolorfully	ライブカラーで
retriever	レトリーバー
places	場所
animelover	アニメーションオーバー
alanya	アラニヤ
musiclife	ミュージックライフ
stadium	スタジアム
jumping	ジャンプする
vlog	ブログ
bulimia	過食症
happyhumpday	ハッピーハンプデー
felicidades	フェリシダデス
newera	新時代
tasbagus	タスバガス
jr	ジュニア
rocky	岩場
darling	ダーリン
msk	msk
donut	ドーナツ
buenastardes	ブエナスタード
казахстан	казахстан
shorthairdontcare	ショートヘアケア
postcard	はがき
citylights	街の明かり
chicas	シカ
liberty	自由
happykid	ハッピーキッド
funnyvideos	面白い動画
partnerincrime	共犯者
ftwotw	ftwotw
beautyful	美しい
concealer	コンシーラー
jyp	ジプ
eyemakeup	アイメイクアップ
deals	お得
mutt	突然
muchlove	muchlove
instasg	インスタント
monument	記念碑
instaweed	仕込み
rawvegan	rawvegan
personalshopper	パーソナルホッパー
dean	ディーン
ne	ネ
harbour	港
catwalk	キャットウォーク
swordartonline	ソードアートオンライン
lago	ラゴ
peruvianhair	ペルビアンヘア
freehand	フリーハンド
gap	ギャップ
ccs	ccs
instamom	インストラム
perrieedwards	ペリー・エドワーズ
muajakarta	ムジャジャルタ
currentmood	カレントムード
ido	私がやります
muffin	マフィン
perfeito	パーフェイト
rad	ラド
lime	ライム
leeyum	レイヨム
minneapolis	ミネアポリス
watchesofinstagram	watchesofinstagram
kinder	キンダー
tattoogirl	タトゥージョル
bajukurung	バフクールン
pierced	穿孔された
helmet	ヘルメット
christmasparty	クリスマスパーティー
galicia	ガリシア
innovation	革新
makeuplook	makeuplook
bangalore	バンガロール
jualhijab	ジュリアヒブ
formal	フォーマル
sunrays	太陽の光
homies	家
essen	エッセン
actors	俳優
styleinspo	スタイルインポ
calum	カリム
blanket	毛布
jelena	ゼレナ
diwali	ディワリ
tank	タンク
tears	涙
отдыхаем	отдыхаем
insta_bw	insta_bw
wake	目覚め
mosque	モスク
caferacer	ケフェア
ha	ハ
madeinusa	アメリカ製
hell	地獄
killme	私を殺して
sj	sj
group	グループ
lens	レンズ
ramadhan	ラマダン
igersbnw	igersbnw
sneakerholics	スニーカーホルター
ilovetravel	旅行が好きです
bun	バン
kwonjiyong	クォンジヨン
norcal	ノルカル
pattaya	パタヤ
summer16	夏16
filmcamera	フィルムカメラ
ultra	ウルトラ
interesting	面白い
fanpage	ファンページ
foodiegram	食べ物
instablackandwhite	インスタント＆ホワイト
petal	花弁
cutekids	かわい子
instaquotes	instaquotes
laamo	ラ・アモ
addict	中毒
grazie	グラツィエ
weddinggown	結婚式用のガウン
igstyle	igstyle
cheatmeal	きれいな食事
singers	歌手
over	以上
gentlemen	紳士
rescuedogsofinstagram	図を救済する
28	28
slimming	スリミング
taekwondo	テコンドー
hokkaido	北海道
barbergang	バーバーガング
seahawks	シーホークス
subscribe	申し込む
hotdog	ホットドッグ
instarun	イスタンブール
instadraw	instadraw
fashionlovers	ファッションオーバー
thehungergames	ハンガー・ゲーム
concrete	コンクリート
jetfuelcantmeltsteelbeams	ジェット燃料マント鋼
fbloggers	fbloggers
mylittlepony	ミリトンポニー
oktoberfest	オクトーバーフェスト
hters	馬鹿
sausage	ソーセージ
pushpullgrind	プッシュプルグラインド
mextagram	ミックスグラム
skatepark	スケートパーク
vehicle	車両
calico	カリコ
clown	ピエロ
instamania	イスタンブール
trendsetter	トレンドセッター
ijs	ijs
fashioninsta	ファインスタ
filha	フィリハ
justiceleague	正義
tatto	タトゥー
dogmom	ドッグモム
traveldiary	旅行日記
igkids	igkids
tattooist	刺青師
rollsroyce	ロールスロイス
parade	パレード
pillow	枕
sehat	セオハット
streetworkout	ストリートアウト
travelph	旅行
coffeelovers	coffeelvers
legendary	伝説の
alex	アレックス
harlem	ハーレム
gece	ゲーシー
kaylaitsines	カイライツ派
beautycare	美しい
stencil	ステンシル
lithuania	リトアニア
mopar	モパー
mykonos	ミコノス
jewel	宝石
kidrauhl	kidrauhl
network	ネットワーク
bajubranded	バージンランド
dying	死んでいる
igersbrasil	イージーブラジル
vapetricks	vapetricks
weddingflowers	ウェディングフラワー
diary	日記
wella	ウェルア
stationery	文房具
idgaf	イドガフ
instanight	インスタント
naturelove	自然界
serum	血清
global_hotshotz	global_hotshotz
sosweet	とても甘い
cigars	葉巻
q	q
who	誰
rapmon	ラモン
dubaimall	ドバイモール
ceremony	式
vi	vi
crab	カニ
roadbike	ロードバイク
bodytransformation	ボディ変換
pomade	ポマード
np	np
sanrio	サンリオ
foodandwine	フードアンドワイン
dinosaur	恐竜
kenya	ケニア
bucaramanga	ブカラマンガ
macau	マカオ
halloween2015	halloween2015
abiye	アビエイ
kayak	カヤック
teacherlife	教師生活
jamtangancowok	ジャムタンガノワク
broccoli	ブロッコリ
malaysianhair	マレーシアの髪
charlie	チャーリー
snowing	降雪
frog	カエル
rockabilly	ロカビリー
tudolindo	ツドリンド
cant	傾ける
ss17	ss17
лето2016	лето2016
naildesigns	ネイルデザイン
декор	декор
opportunity	機会
garage	ガレージ
carrots	人参
ruby	ルビー
減肥藥	減量薬
bepositive	ポジティブになれ
compras	コンパス
kaosdistro	カオスディストロ
chibi	ちび
stevenuniverse	スティーブンユニバース
plugs	プラグ
pintura	ピンツラ
colorfull	カラフルな
instabike	元気
snk	snk
funko	ファンクコ
score	スコア
kanye	カニエ
awkward	厄介な
corrida	コリーダ
holidayseason	連休シーズン
myjam	マイジャム
opera	オペラ
blah	ああ
gohardorgohome	ゴーハードルゴホーム
percyjackson	パーシー・ジャクソン
johor	ジョホール
rd	rd
cakestagram	ケーキ
busy	忙しい
siempre	siempre
splash	スプラッシュ
tasarim	タサリム
internationalwomensday	国際婦人デー
purposetour	目的地
christmaslights	クリスマスのあかり
jubah	ジュバ
sewin	縫う
lifecoach	ライフクロッシ
iphoneasia	イファナシア
hijabindonesia	ヒジャブインディア
me	私
taylor	テイラー
write	書きます
drugs	薬物
lizard	トカゲ
prayers	祈り
pb	pb
skater	スケーター
ilovemylife	私の人生が好き
besiktas	ベシクタ
airbus	エアバス
bikeporn	自転車
buzzfeedfood	バズフィード
benefit	利益
myhero	私のヒーロー
wintertime	冬
godson	ゴッドソン
noworries	心配ない
bonheur	骨抜き
305	305
gohard	ゴーハード
jinyoung	ジンヨング
downhill	下り坂
sashimi	刺身
shred	細断した
indianhair	インド系
atelier	アトリエ
kidsstyle	子供のスタイル
jambi	ジャンビ
patagonia	パタゴニア
bandungjuara	バンドンジュアラ
sepatuanak	セパナナク
north	北
tmnt	tmnt
freckles	そばかす
automotive	自動車
mavi	マビー
monterrey	モンテレー
nuts	ナッツ
computer	コンピューター
pitbulllove	ピットブルブ
insane	狂人
kemejabatik	ケメジャバティック
celanajeans	セラニヤーズ
myjob	私の仕事
taskeren	タスクレーン
bbgcommunity	bbgcommunity
челябинск	челябинск
rsa_streetview	rsa_streetview
advent	出現
myangel	私の天使
peninggibadan	ペンギンババダン
mufc	mufc
playstation4	プレイステーション4
oss	オス
canal	運河
official	公式
tmj	tmj
satisfying	満足する
filming	撮影
communityfirst	コミュニティファースト
morphebrushes	モルフォブ
united	ユナイテッド
playhard	一生懸命遊べ
pickoftheday	ピックソフトディーディー
mod	モード
tattoodesign	タトゥーデザイン
partymusic	パート・ミュージック
build	ビルドする
somuchlove	そんなに愛
bangs	前髪
farewell	お別れ
eater	食べる
ama	アマ
montenegro	モンテネグロ
nomad	遊牧民
pictureperfect	映像完全
instasmile	インスタスマイル
cucumber	きゅうり
instaplaceapp	instaplaceapp
myjourney	私の旅
bikinicompetitor	ビキニコンパッタ
coilporn	コイルポン
myboo	マイブー
instapost	イスタンブール
luckygirl	ラッキーガール
halo	ハロー
rasta	ラスタ
relaxtime	リラックスタイム
wavyhair	ウェーブのかかった髪
caps	キャップ
murica	ムリツァ
pantai	パンタイ
美味しい	美味しい
vintageshop	ヴィンテージショップ
saintlaurent	聖霊
ventas	ベント
halfmarathon	ハーフマラソン
aw	aw
artlovers	アートオーバー
festainfantil	フェスタインファントル
campo	カンポ
yurionice	ユリオニス
obey	従う
pacificnorthwest	パシフィックノースウェスト
lovelyday	素敵な一日
soldier	兵士
like4me	like4me
kemejacowok	ケメジャコウォク
newshoes	新しい靴
matrimonio	結婚式
moscowcity	モスクワシティ
bong	ボン
cfc	cfc
landmee	土地
sportscars	スポーツキャスター
empowerment	エンパワーメント
scottishfold	スコティッシュフォールド
oh	ああ
massachusetts	マサチューセッツ州
james	ジェームズ
jrt	Jrt
fiori	フィオリ
il	il
tunisia	チュニジア
украшения	украшения
standup	立ち上がる
назаказ	назаказ
weighttraining	ウェイトトレーニング
britishshorthair	英国式
let	〜する
undertale	undertale
cuteboy	かわいい男の子
estetica	エステティカ
gutenmorgen	グーテンモルゲン
photoday	光ファイバー
parque	ペルケ
belly	腹
petlover	ペトーバー
kings	王様
web	ウェブ
htown	htown
anna	アンナ
frenchielove	frenchielove
giants	巨人
website	ウェブサイト
gospel	福音
интерьер	интерьер
arrow	arrow
atasanmurah	アタザンムラ
gelinlik	ゲルリンク
khimarsyari	キマタルヤリ
lasamo	ラサモ
волгоград	волгоград
fl	fl
befit	〜に合う
atmosphere	雰囲気
sustainable	持続可能な
champs	チャンピオン
allshots	すべてのショット
riri	リリ
bookaholic	ブックハプティック
britishcolumbia	ブリティッシュコロンビア
collar	襟
universal	ユニバーサル
growing	成長する
lovelove	lovelove
selangor	セランゴール
pune	プネ
tanned	日焼けした
mt	mt
patterns	パターン
hsdailyfeature	hsdailyfeature
seetheworld	世界を見ましょう
dotwork	ドットワーク
copic	コピック
_	_
peony	牡丹
motherdaughter	母娘
yokohama	横浜
iphonephoto	iphonephoto
graffitiporn	落書き
sangria	サングリア
al	アル
nose	鼻
igersportugal	igersportugal
hobi	ホビー
nursery	保育園
fuckcancer	fuckcancer
instatrip	図書館
byme	byme
birra	ビラ
igs	igs
ynwa	イヌワ
shahalam	シャハラム
hermanas	ヘルマナス
tia	ティア
hijabista	ヒジャビスタ
agua	アグア
puppylife	puppylife
bestpicture	一番良い写真
sauce	ソース
gaybear	ゲイベア
itgirl	itgirl
vidasana	ヴィダサナ
supermodel	スーパーモデル
herbalife24	ハーバライフ24
was	あった
fame	名声
onlineshopph	オンラインホップ
riau	ライオウ
vinyljunkie	ビニュッキー
stylenanda	Stylenanda
drinkup	飲み干す
exoticcar	エキゾチックな車
nikemurah	ニケムラ
musclecar	マッスルカー
shakeology	揺れ
thankyoulord	強盗
scorpio	蠍座
explorebandung	探検隊
afterparty	アフターパーティー
surreal	シュールレア
closet	クローゼット
beikta	ビックタ
clearsky	晴天
krakow	クラクフ
monotone	単調
jaguar	ジャガー
igersparis	イゲサーリス
grandcanyon	グランドキャニオン
mydogiscutest	ミドゲストテスト
clickinmoms	clickinmoms
kaoscowok	カオスコウォク
trek	トレッキング
parkour	パルクール
igersturkey	igersturkey
petoftheday	恋人
тюмень	тюмень
keren	ケレン
gemini	ジェミニ
when	いつ
jessica	ジェシカ
rise	上昇
quietthechaos	静かなカオス
tagafriend	タグの友人
balcony	バルコニー
trails	トレイル
insta_global	insta_global
polefitness	極端な
coloring	着色
coverup	隠ぺいする
page	ページ
grapes	ブドウ
linecamera	ラインカメラ
cashfollowtrain	キャッシュフロートレイン
vermont	バーモント
animedrawing	アニメリング
jaw_dropping_shots	jaw_dropping_shots
geneva	ジュネーブ
kidzfashion	kidzfashion
mvp	mvp
exams	試験
sunkissed	日焼けした
vegas2015	vegas2015
eidmubarak	エイド・ムバラク
su	ス
mujeres	ムジェール
eco	エコ
instagroove	instagroove
scenegirl	シーンガール
blondhair	金髪
ok	OK
potatoes	ポテト
diyet	ジエット
addme	私を追加してください
jacksonwang	ジャクソンワング
bodyfitness	ボディフィットネス
kemejapria	ケメヤプリア
nailartist	ネイチャーズ
kitties	子猫
petty	些細な
sommar	ソムマー
writers	作家
monstax	モンスター
tassekolah	タセコラ
turntup	ターンアップ
stuff	もの
шоурум	шоурум
po	ポー
pereira	ペレイラ
amigurumi	アミグルミ
cutedogs	Cutedogs
vitamins	ビタミン
desing	デザイニング
velvet	ベルベット
littleman	小さな男
yenisezon	円高
folowme	フォローミー
moody	ムーディー
kick	キック
benim	ベニム
doberman	ドベルマン
daughters	娘
девочки	девочки
tupac	ツーパック
instafrenchie	instafrenchie
ecofriendly	エコフレンドリーな
andalucia	アンダルシア
ancient	古代
medical	医療
girlswholikegirls	girlswholikegirls
sneakerfiles	スニーカーファイル
dolce	ドルチェ
ilike	好き
scrapbooking	スクラップブッキング
megusta	メグスタ
sepatubranded	結婚した
sepatucasual	海綿体
walks	あるきます
carstagram	カルテグラフ
everyone	みんな
frankiero	フランキーロ
tdl	TDL
giraffe	キリン
like4followers	like4followers
babysitting	ベビーシッター
van	バン
bulls	雄牛
quotestagram	クエストマップ
world_shotz	world_shotz
aperitivo	アペリチヴォ
mundo	文堂
_	_
hunk	塊
marquee	マーキー
vscomoscow	vscomoscow
rockclimbing	ロック・クライミング
facial	フェイシャル
busanamuslim	バサナムスリム
hechoenvenezuela	ヘチェンヴェンズエラ
dessin	デッサン
kuwaiti	クワイティ
cewek	クウェーク
breakingbad	不良になる
mypassion	私の情熱
vamoquevamo	ヴァモケバモ
sunset_madness	sunset_madness
redlipstick	赤い口紅
haters	憎しみ
workouts	トレーニング
ahs	ああ
houses	家
ribs	リブ
hermano	ヘルマノ
thankgod	ああ、助かった
amazingview	素晴らしい景色
bt	bt
fireplace	暖炉
reader	リーダー
direction	方向
igersmalaysia	イガーマレーシア
copper	銅
沖縄	沖縄
tweetgram	トゥイットグラム
sandal	サンダル
les	レ
instablooms	instablooms
amordaminhavida	アモーダミンハビダ
guayaquil	グアヤキル
repostwhiz	repostwhiz
ale	エール
bassfishing	ベースフィッシング
link	リンク
jualkaos	ジャルカス
gti	gti
rfr	rfr
instahomo	スタホモモ
buffalo	バッファロー
volcano	火山
transformers	変圧器
улыбка	улыбка
aburrida	アブリダ
stormtrooper	ストームトルーパー
vscoaward	vscoaward
beawesome	素晴らしい
bikers	バイカー
мой	мой
djmalik	ジマルク
trash	ごみ
camber	キャンバー
bacheloretteparty	独身パーティー
healthcoach	健康コーチ
gamisbusui	ガンジーブスイ
ubud	ubud
суббота	суббота
бренд	бренд
catholic	カトリック
match	一致
ulzzang	ulzzang
las	ラス
bank	バンク
growyourown	growyourown
littleandbrave	リトル・ブラッド
ethnic	エスニック
ratchet	ラチェット
nl	nl
singersongwriter	シンガーソングライター
as	として
instanaturelover	インスタンスオーバー
semanasanta	セマナサンタ
29	29
prep	準備
che	チェ
99	99
flamingo	フラミンゴ
beaches	ビーチ
turnt	ターン
drawingoftheday	美しい
guadalajara	グアダラジャラ
disneyprincess	ディスネプリン処理
bikeride	バイクに乗ること
oxford	オックスフォード
ceramic	セラミック
santamarta	サンタマルタ
dressimport	ドレスインポート
sundaymood	日曜大工
toulouse	トゥールーズ
detailing	詳細
capital	資本
parisjetaime	パリジェイム
tags4like	tags4like
demon	悪魔
property	プロパティ
strongman	実力者
urbanexploration	都市探査
nadinelustre	ナディルネルスト__レール
kolye	コライ
sweaterweather	セーター天気
горы	горы
wa	ワ
amc	amc
necklaces	ネックレス
violin	バイオリン
kadopacar	カドパカル
waltdisney	ウォルト・ディズニー
peaceandlove	平和と愛
giant	巨人
couponing	クーポン
journal	ジャーナル
lightning	ライトニング
paramore	パラモア
workingout	運動
jackrussellterrier	ジャックルセルテル
instasunda	インスタントゥンダ
samba	サンバ
blondegirl	ブロンドガール
sos	ソーズ
countryliving	闘争
scuba	スキューバ
waikiki	ワイキキ
notebook	ノート
cny	人民元
aventura	アベンチュラ
vanlife	バンライフ
nothing	何も
sunum	サウム
asana	アサナ
dreadlocks	ドレッドロック
belt	ベルト
marathontraining	麻酔術
seascape	海景
weddinginspo	weddinginspo
thirstythursday	渇きの日
puebla	プエブラ
antiques	骨董品
snorkeling	シュノーケリング
insanity	狂気
avon	エイボン
istagram	イシュグラム
ftm	ftm
ferie	フェリー
paintball	ペイントボール
ygfamily	ygfamily
jubahmurah	ジュバムラ
хабаровск	хабаровск
лес	лес
spinning	紡糸
soblessed	とても祝福された
mamma	乳房
bnw_demand	bnw_demand
dabbersdaily	大変身
minimalmood	ミニマムムード
tivogliobene	チボトリオベン
sepatuolahraga	セパオララガ
tulum	トゥルム
obrigadadeus	帯状疱疹
jardin	ジャルダン
fairytale	おとぎ話
edebiyat	エベブヤット
travelpic	旅行の
republicadominicana	共和国アモミナナ
cincin	シシン
lovebird	恋人
kicksoftheday	キックソフトディッシュ
kidzootd	kidzootd
westie	ウェストリー
artista	芸術家
epcot	エプコット
nightview	夜景
kyliecosmetics	キリコッセ
digitalmarketing	デジタルマーケティング
liburan	リブラン
coolhair	クールヘア
normanikordei	ノルマルニコロディ
lo	ロ
longchamp	ロングシャン
instadisney	インスタジニス
palestine	パレスチナ
sertanejo	セルタネホ
mer	マー
prismacolor	プリマルカラー
lily	ユリ
shoestagram	舞台挨拶
abaya	アバヤ
dots	ドット
marketingdigital	marketingdigital
illinois	イリノイ
kaosanak	カオサナク
fashionistas	ファッショニスタ
instagramturkey	インストラクション
calabria	カラブリア
maserati	マセラティ
theforceawakens	Theforceawakens
excercise	エクササイズ
sporty	スポーティー
френч	френч
jogjakarta	ジョグジャカルタ
darlingweekend	ダーリンウィークエンド
barbers	理髪師
greenery	緑
csgo	csgo
likefortags	likefortags
tutu	ツトゥ
харьков	харьков
ラーメン	ラーメン
bethechange	ベチェチェンジ
платья	платья
お弁当	お弁当
piter	ピター
scifi	SF
ilikeit	私はそれが好きです
diadosnamorados	ジアドスナモラドス
бизнес	бизнес
instayum	事務所
evo	エヴォ
amormeu	アモーメゥ
yankees	ヤンキー
butter	バター
musiclover	音楽が好きな人
sleepover	寝床
jamesreid	ジャムズレイド
commercial	商業の
bajubatik	バジュバク
aksesorismurah	アクスシスムラ
looking	探している
zarathailand	ザラサトラン
heavy	ヘビー
principe	プリンシペ
kulot	キュロット
dino	ディーノ
nismo	ニスモ
firefighter	消防士
dua	デュア
morena	モレナ
wacky	変な
mlm	mlm
happyanniversary	記念日おめでとう
zyzz	ズィーズ
add	追加する
wetrepublic	ウェットレプリカ
shotzdelight	ショットズライト
visualambassadors	ビジュアル・バサード
sonyimages	ソニーイメージズ
hoy	ホーイ
supra	上記に
cachos	カチョー
ねこ部	ねこ部
watchthisinstagood	見てみよう
salt	塩
euro2016	ユーロ2016
rippedjeans	リップジーンズ
kayaking	カヤック
fest	祭り
apples	りんご
nature_sultans	nature_sultans
bolivia	ボリビア
alimentacaosaudavel	アライメントサソサダベル
miniature	ミニチュア
duomo	ドゥオモ
завтрак	завтрак
global	グローバル
bap	バップ
joint	ジョイント
belgrade	ベオグラード
captain	キャプテン
frasi	フレイジー
coming	到来
timberland	ティンバーランド
kaskus	カスカス
frost	霜
graduate	卒業
indigo	インジゴ
naturephoto	自然の写真
boracay	ボラカイ
snailwhite	スネイルホワイト
thunder	サンダー
мотивация	мотивация
loyal	忠実な
jul	ジュール
meer	マイヤー
harajuku	原宿
sofia	ソフィア
stilllife	静物
2k15	2k15
choiseunghyun	チョルスンウンウン
кофе	кофе
taetae	タエタエ
pooltime	プールの時間
happytuesday	良い火曜日を
souhilabenlachhab	スッヒラベンラッハブ
carwash	洗車
воронеж	воронеж
davidbowie	デビッドボーイ
sevgili	セビギリ
elite	エリート
upperleftusa	アッパーレフトサ
peoplescreative	人々のクリエイティブ
colori	カラー
beautifulcuisines	美しいクッション
clique	クリーク
ich	ich
segue	セグエ
indovidgram	無気圧図
divas	ディーバ
give	与える
summerstyle	夏のスタイル
halloween2017	halloween2017
au	au
liquor	酒
strange	奇妙な
mgm	mgm
21dayfix	21dayfix
birthdays	誕生日
ovo	卵
artshow	美術展
mis	ミス
marktuan	マークトゥアン
fragrance	香り
aruba	アルバ
past	過去
balloon	バルーン
joking	冗談
instamorning	instamorning
香港	香港
babys	ベビー
teachers	教師
goddaughter	おばあちゃん
memyselfandi	記念日
playground	遊び場
insta_crew	insta_crew
summerbody	サマーボディー
sold	売った
herbs	ハーブ
bbctravel	bbctravel
hkboy	ヒッコイ
bavaria	バイエルン
latin	ラテン
waffle	ワッフル
customcasemurah	カスタムカセムラ
pinklips	ピンクスリップ
yogapants	ヨーガパンツ
купить	купить
beautyaddict	美容師
nightsky	夜空
heelsmurah	ヒールズムラ
outdoorlife	アウトドアライフ
implus_daily	implus_daily
forgiveness	許し
pompom	ポンポン
aerial	空中
day6	6日目
merci	メルキ
омск	омск
blurryface	ぼんやりした顔
gettingfit	着陸する
signs	兆候
joggerpants	ジョギングパンツ
sunnies	日の出
gathering	集まる
alisveris	アリスビスシス
доставка	доставка
palmsprings	パームスプリング
kcco	kcco
anorexic	食欲不振
manoloblahnik	マノロブラニク
gem	宝石
fattofit	ファットフィット
product	製品
todayskicks	今日の暇つぶし
bellas	ベラス
vero	ベロ
fringe	フリンジ
advice	助言
pernambuco	ペンパンブコ
oscar	オスカー
br	br
bodywave	ボディウェーブ
santabarbara	サンタバーバラ
салонкрасоты	салонкрасоты
lax	怠惰
musicallyapp	musicallyapp
smartphone	スマートフォン
donate	寄付する
renovation	改装
twitch	つまらない
investment	投資
bottle	ボトル
2009	2009年
exciting	エキサイティング
kidsootd	kidsootd
macaron	マカロン
handsomeboy	ハンサムボーイ
jualtasimport	jualtasimport
nephews	甥たち
asmr	asmr
steam	蒸気
instashopmalaysia	喀痰浸潤
unforgettable	忘れられない
actorslife	アクターズライフ
doit	〜する
dubailife	二輪車
fitnessinspiration	フィットネスインセンス
three	三
pies	パイ
aunt	叔母
cardiff	カーディフ
getoutstayout	getoutstayout
禮物	禮物
demi	デミ
paraiso	パライソ
crimea	クリミア
girlswhovape	ガールズウェーブ
vscomoment	vscomment
noshame	ノシメ
blackbeauty	黒馬物語
londoneye	londoneye
polkadots	水玉
paysage	ペイジー
ihabamir	イハバミール
pirate	海賊
ella	イェラ
roof	ルーフ
chopper	チョッパー
alive	生きている
gymgirl	ジムガール
comicbooks	漫画本
siam	サイアム
techhouse	ハイテクハウス
abmlifeiscolorful	卒業生
pets_of_instagram	pets_of_instagram
laborday	労働者の日
beachtime	ビーチタイム
jualcaseiphone	ジュラケイスフォン
yemek	イエメク
equine	ウマ
scubadiving	スキューバダイビング
mountainlife	山岳生活
partying	パーティー
stlouis	ストルース
coachthailand	コーチタイランド
bazaar	バザール
sanat	サナット
wavy	波打つ
mygarden	私の庭
pentax	ペンタックス
hatersgonnahate	言いたい奴には言わせとけ
semijoias	セミホワ
anchor	アンカー
islamic	イスラム
update	更新
notreally	あんまり
homemadefood	手作りの料理
koreanstyle	韓国スタイル
tudodebom	チューダーコード
girlstrip	ガールストリップ
sws	スウィング
marriedlife	結婚生活
levi	レヴィ
cricket	クリケット
lensculture	レンズカルチャー
clothingline	衣類
domenica	ドミニカ
dancelife	ダンシーライフ
happines	幸せ
bw_society	bw_society
nowspinning	ノーズピニング
chefsofinstagram	シェフの姿勢図
bayan	バヤン
myday	私の一日
omega	オメガ
ilovethem	私は彼らを愛しています
sarawak	サラワク
ham	ハム
travelers	旅行者
analogphotography	アナログ写真
bajucantik	バジュカントク
liked	好き
tendencias	テンペシアス
outlet	出口
worldbestgram	ワールドベストセグ
adidasmurah	アディダスムラ
angry	怒っている
leon	レオン
lfc	lfc
caseiphone6	caseiphone6
puppydog	puppydog
horseriding	乗馬
sealife	海の生物
drank	飲んだ
robot	ロボット
tattooflash	タトゥーフラッシュ
mouse	マウス
illustrations	イラスト
beatles	ビートルズ
wisewords	賢明な言葉
gross	キモい
worlderlust	worlderlust
calivapers	カリベツ
fifa15	FIFA15
cutepuppy	かわいい子犬
puppyoftheday	ごみ処理場
stella	ステラ
beautifulplaces	美しいところ
uniform	統一
mytripmyadventure	mytripmyadventure
lafamilia	ラファミリア
muttsofinstagram	muttsofinstagram
freedomthinkers	自由挑戦者
quiet	静か
cambridge	ケンブリッジ
onfleek	オンフリック
bv	bv
strengthtraining	筋力トレーニング
hit	ヒット
gata	ガータ
handwriting	手書き
cityview	シティビュー
concierto	コンチェルト
volvo	ボルボ
jualjam	ジュリアン
stockings	ストッキング
familyovereverything	家族が一番
spreadlove	スプレッドローブ
aotd	aotd
firstday	初日
drifting	漂流
イマソラ	イマソラ
achieve	達成する
guineapig	モルモット
tops	トップス
goodpeople	善良な人
musicproducer	音楽プロデューサー
pan	パン
olshopid	オルチシッド
nsk	nsk
marine	マリン
apartment	アパート
lifestylechange	ライフスタイルの変更
hijabsolo	ヒジャブロ
chuva	チュヴァ
выходной	выходной
tires	タイヤ
historic	歴史的な
morningmotivation	朝起きる
webdesign	ウェブデザイン
makeupblogger	makeupblogger
gemstones	宝石類
trendykiddies	トレンドキッズ
winetime	ウィンタイム
mommysgirl	mommysgirl
1st	1位
kocham	コチャム
kicks0l0gy	キック0l0gy
seriously	真剣に
9gag	9gag
watching	見ている
buttercream	バタークリーム
law	法律
viajes	ビヤージュ
nb	nb
visitnorway	訪問の道
plaza	プラザ
career	キャリア
photojournalism	フォトジャーナリズム
goodgirl	いい娘
kitkat	キットカット
amstaff	アムスタフ
cottage	コテージ
sbntown	セブンタウン
gymfreak	ジムフリーク
missu	ミス
butterflies	蝶
if	if
diner	食堂
westside	西側
stanced	歩く
vapeshop	バプショップ
sobrino	ソブリノ
noiretblanc	ノワレブラン
badgirl	バッドガール
dimples	ディンプル
purelove	純粋な
sepatucewe	シパツェツェ
neve	ね
iconic	象徴的な
encouragement	奨励
yesplease	はい、お願いします
yorkiesofinstagram	yorkiesofinstagram
kuw	キュウ
restaurante	レストラン
ballin	バリン
スタバ	スタバ
darkside	暗黒面
unisex	ユニセックス
woodwork	木工
loveya	好きだよ
gelish	ゲルシシュ
genius	天才
mono	モノ
energia	エネルギー
lgbtpride	lgbtpride
nsw	nsw
idaho	アイダホ
instagraffiti	インガトラフィティ
dom	ドーム
liveyourlife	ライブライフ
jilbabsyari	ジルバブヤリ
boudoir	屋内
fashionbag	ファッションバッグ
catofinstagram	catofinstagram
seragambatik	セラガンバティク
iam	わたし
orchid	蘭
designdeinteriores	デザインディレクター
sharpie	シャーピー
luxurious	豪華な
formula1	式1
quotesoftheday	引用しています
ck	ck
fixedgear	固定歯車
buylocal	buylocal
cuore	クオーレ
bajuimportmurah	バジャイポートミュラ
deli	デリ
magcon	マグコン
calcio	カルシオ
legacy	遺産
dost	ドスト
jajaja	ジャジャジャ
weekendgetaway	週末のお出掛け
winterfun	ウィンターフン
miercoles	巨人
dresscantik	ドレスキャントク
doodling	落書き
vscoukraine	vscoukraine
musicfestival	音楽祭
foe	敵
asava	アスワン
loser	敗者
birthdayweekend	誕生日ウィーク
emma	エマ
vacationmode	休暇モード
rv	RV
cantsleep	挑戦する
vivalasvegas	ビバラガス
enlightenment	啓発
tfios	tfios
offensive	攻撃
humanhair	人間の髪の毛
sisepuede	シセプデード
аксессуары	аксессузеры
cowgirl	カウガール
grancanaria	グラナカリア
royalty	ロイヤリティ
artcollective	アートコレクティブ
emotional	感情の
туфли	туфли
bnwmood	bnwmood
mommyandme	お母さん
カフェ	カフェ
foodforfoodies	食料品
likeforalike	likeforalike
redken	レッドケン
vegasnightlife	vegasnightlife
nasa	ナサ
inredning	インレディング
footwear	履物
soulmates	ソウルメイト
tesettur	テセッタ
walmart	ウォルマート
sneakerfreak	スニーカーフリーク
poker	ポーカー
nailsdid	nailsdid
changes	変更
luck	運
cbd	cbd
nordeste	ノルデステ
stayhigh	ハイのままで
richmond	リッチモンド
beauties	美しさ
wildflowers	野生の花
kadowisuda	カドウィスダ
familyvacation	家族連れ
adam	アダム
modaparameninas	modaparameninas
hb	hb
familygoals	ファミリーゴール
tommyhilfiger	トミー・ヒルフィガー
drais	ドレス
libros	聖書
fave	ファーブ
olshopsemarang	オルシペマラン
handcheck	手チェック
tone	トーン
langsing	ラングス
bootyfordays	ブートウォーディーズ
taskerja	タスク担当者
sobrina	ソブリナ
kayseri	カイセリ
liketkit	似たもの
preschool	幼稚園
www	www
christmasiscoming	クリスマスが来ています
botox	ボトックス
goiania	ゴイアニア
take	取る
acura	アキュラ
premierleague	プレミアリーグ
day5	5日目
jacobsartorius	ヤコブサルトリウス
lovewhatido	愛の言葉
減肥貼	低廉貼
bimmer	ビーマー
healthiswealth	健康こそが資産
italianstyle	イタリア風
brush	みがきます
alpha	アルファ
bento	弁当
gangsta	ギャングスタ
robin	ロビン
traindirty	トラインダーティ
detalles	デタール
lamb	子羊
gear	ギヤ
8марта	8ヶ月
drum	ドラム
ua	あなた
акция	акция
mercy	慈悲
edmlife	エドマイフ
streetmobs	ストリートモブ
healthybody	健康な体
siamese	シャム
edmonton	エドモントン
erasmus	エラスムス
2ne1	2ne1
drinklocal	飲酒地
honduras	ホンジュラス
neversettle	解決しません
vixx	vixx
karde	カーデ
bikinifitness	二人乗り
americanhorrorstory	アメリカン・ホラー・ストーリー
staff	スタッフ
chi	カイ
thisislondon	thisislondon
2pac	2pac
wochenende	ウォーケンデ
upsidedown	逆さまに
part2	パート2
bandana	バンダナ
cartoons	漫画
oldphoto	古い写真
missuniverse	ミス・ユニバース
bumpin	バンプン
hedgehog	ヘッジホッグ
bajugrosir	バジューロシール
yogateacher	ヨガテッハー
autumnleaves	紅葉
kylie	カイリー
muslimahfashion	ムスリムファッション
trx	trx
barn	納屋
instart	インスタント
trustedshop	信頼できるショップ
coolkids	かっこいい子達
arkansas	アーカンソー
beergeek	ビールギク
rage	怒り
bikinis	ビキニ
sigma	シグマ
brotherandsister	兄弟姉妹
com	com
prosecco	プロッコ
barbados	バーバード
astonmartin	アストンマーチン
womenstyle	女性のスタイル
jualbeli	ジュベリ
coffeelove	コフェリーベ
iron	鉄
bsb	bsb
obsession	強迫観念
summer2013	夏
instgram	プログラム
split	スプリット
nailaddict	ネイルアドレス
endurance	耐久
mixed	混合
bonita	ボニータ
vacanze	休暇
art_spotlight	アートスポットライト
phil	フィール
stayfocused	stayfocused
vscotravel	vscotravel
firstbirthday	最初の誕生日
cuts	カット
preach	説教
myhappyplace	myhappyplace
benimkadrajim	ベニカドラジム
disneyside	椎間板ヘルニア
pass	パス
mate	メイト
celebrities	有名人
keywest	キーウエスト
wrangler	ラングラー
editing	編集
corgisofinstagram	図形図
facetime	ファーストタイム
plaid	格子縞の
classiccars	クラシックカー
kadoulangtahun	カドゥラントンフン
nourish	栄養を与える
momblogger	ママブロガー
swimbikerun	スンビケルン
foodbeast	フードビースト
emoji	絵文字
rokmurah	ロクラフ
backday	バックデー
charm	チャーム
stretching	ストレッチ
dehoje	ドホエ
bir_dakika	bir_dakika
kaylasarmy	kaylasarmy
muffins	マフィン
footfetishnation	足取り
esmagaquecresce	esmagaquecresce
bodas	ボダ
busan	釜山
fitgirlsguide	フィットガールズガイド
try	お試しください
волосы	волосы
mextures	祈り
truecooks	トゥルークック
пермь	пермь
discovery	発見
boosted	ブーストされた
ontheblog	オンザブログ
nutricao	ナトリカオ
tarte	タートル
weekendfun	weekendfun
letitgo	手放す
bho	ボー
baba	ババ
toycrewbuddies	ツイートする
videography	ビデオ撮影
etude	エチュード
iwokeuplikethis	イオウクプリケチス
pow	捕虜
fiat	フラット
baker	パン屋
kutubaru	クチュール
bonappetit	おまかせ
soda	ソーダ
stoked	ストーク
luxuryhomes	豪華な家
smokeyeye	スモーシーアイ
gaydude	ゲイデ
almuerzo	アルムエルゾ
dietsehat	ダイエット
scars	傷跡
ransel	ransel
tarot	タロット
mehndi	メンディ
felizdia	フェリツィア
poetsofig	poetsofig
bamboo	竹
inspirao	インスピラ
livinglife	人生を生きる
goldensofinstagram	ゴールデンソフィンググラム
onset	開始
startuplife	スタートアップ
tasselempang	タッセルマン
feliznatal	胎生期
yeezyboost350	yeezyboost350
seeyousoon	また近いうちにお会いしましょう
nieces	ニールズ
goprohero	ゴプロロ
doubletrouble	ダブル・トラブル
cheerleading	チアリーディング
homedecoration	家の装飾
koreandrama	韓国人
beardporn	ビールポラン
igersspain	イガースパイン
environment	環境
screenshot	スクリーンショット
palmtree	ヤシの木
oats	オーツ麦
affordable	手頃な価格
prettyinpink	prettyinpink
realism	リアリズム
instyle	イスタンブール
10k	10k
stitch	ステッチ
macbook	マックブック
getstrong	強くなれ
махачкала	махачкала
elfontheshelf	elfontheshelf
cleanse	浄化する
gomez	ゴメス
internet	インターネット
интернетмагазин	интернетмагазин
vest	ベスト
expofilm	expofilm
tactical	戦術的な
wahm	ワーム
masterchef	料理長
toddlerfashion	幼児ファッション
soshi	ソシ
cincinnati	シンシナティ
worldunion	ワールドユニオン
legitseller	合法人
process	プロセス
moderncalligraphy	現代陶磁器
hijabinstan	ヒジャンビスタン
ropa	ロパ
origami	折り紙
catsofworld	catsofworld
maya	マヤ
luxuryliving	贅沢な
steel	鋼
worthless	役に立たない
collector	コレクタ
delrecords	デルレコード
bbs	BBS
gametime	ゲームの時間
elsalvador	エルサルバドル
freelance	フリーランス
greysanatomy	グリーザアナトミー
semangat	セマンガット
positiveenergy	ポジティブなエネルギー
exploringtheglobe	グローブを探索する
besttime	ベストタイム
vdk	vdk
msica	msica
lovedog	愛する者
mpower	mpower
sexymodel	セクシモデル
celebrating	祝う
npcbikini	npcbikini
vikings	バイキング
toneitup	トーンアップ
ftw	ftw
любимая	любимая
fastfood	ファストフード
caldo	カルド
tr15	tr15
wshh	wshh
persiancat	ペルシャンキャット
減肥膏	減量膏
bold	大胆な
glee	喜ぶ
sonnenuntergang	息子の息子
things	もの
his	彼
bootybuilding	ブートビルディング
perawatanwajah	ペワワタンワジャ
jualcelana	ジュールセラーナ
labordayweekend	labordayweekend
собака	собака
sprinkles	スプリンクル
name	名
bw_crew	bw_crew
girlsjustwannahavefun	女の子達は楽しみたいだけ
sempreinsieme	セミプレインシエム
slovenia	スロベニア
peepmysneaks	ピープミスニックス
kar	カール
petlovers	ペトローバー
humanity	人類
taki	タキ
2a	2a
kulinerbandung	クライネ
makasar	マカサール
linework	ラインワーク
philosophy	哲学
illest	ごく普通の
noodle	ヌードル
virgo	ヴィルゴ
pepper	コショウ
oriflame	オリフラム
seohyun	ソヒョン
weloveyou	私たちはあなたを愛してます
vocals	ボーカル
memorialdayweekend	メモリアルデイウィーク
pumpkinpatch	かぼちゃ畑
ram	RAM
toureiffel	トゥルーフィエル
civilwar	民兵
entrenamiento	エンレナミエント
не	не
дома	дома
barbecue	バーベキュー
myanmar	ミャンマー
swmafia	スワマフィア
summeriscoming	そろそろ夏です
bears	クマ
foodspotting	食糧摂取
maxi	マキシ
womenfashion	女性ファッション
tvshow	テレビ番組
consistency	一貫性
britneyspears	ブリトニースピアーズ
west	西
swfamily	恋人
bunnies	ウサギ
libro	小説
koreanfashion	韓国ファッション
beans	豆
emotion	感情
gastronomy	グルメ
vlogger	ビデオログ
carrot	にんじん
bazaronline	バザロン
quito	キート
amethyst	アメジスト
weddingstyle	結婚式
headphones	ヘッドフォン
fashionphotographer	ファッションフォトグラファー
nailtech	ネイルテック
bajumuslimmurah	バジュムスリムラハ
pewpew	ピューフー
catalunyaexperience	カタロニアの経験
brandnew	真新しい
featuremeofh	特集
evento	イベント
niceview	いい眺め
ladybug	ミツバチ
nicaragua	ニカラグア
fitcouple	フィットカップル
beautifulbc	美しい
cordoba	コモーバ
menu	メニュー
theflash	フラッシュ
halloween2016	halloween2016
italianboy	italianboy
teachersofinstagram	teachersofinstagram
middleeast	中東
indianwedding	インディアンウェディング
infant	幼児
summervacation	夏休み
yourself	あなた自身
acne	にきび
dk	dk
lambo	ランボ
49ers	49ers
танцы	танцы
native	ネイティブ
hilife	ヒラリー
breastfeeding	母乳育児
northwest	北西
aboutalook	aboutalook
smooth	滑らかな
rawr	元祖
vines	ブドウ
prop215	prop215
chihuahualove	チワワ語
fotograf	写真
likelike	同様に
cakepops	ケーキポップス
psicologia	心理学
animes	アニメ
staffordshirebullterrier	staffordshirebullterrier
beardedmen	髭剃り
cutecats	カットケット
bromance	臭気
payday	給料日
animalprint	動物柄
runningman	ランニングマン
bull	ブル
earthday	アースデー
tasbandung	地震
how	どうやって
kind	種類
western	西洋
greattime	素晴らしい
bananas	バナナ
ebay	eBay
animeworld	アニエワールド
nubes	ヌーブス
ac	交流
jealous	嫉妬
doyoutravel	旅行しますか
malaysian	マレーシア人
jilbabinstan	ジルババスタン
goodmoments	良い瞬間
halloweenparty	ハロウィーンパーティー
talentovenezolano	タレントヴェネツォラノ
dortmund	ドルトムント
6months	6ヵ月
save	セーブ
aliens	宇宙人
soleonfire	ソロモンファイヤー
same	同じ
calories	カロリー
lb	ポンド
hollister	ホリスター
dressage	調和
gayfit	ゲイフィット
surgery	手術
sissy	シシー
smallbiz	SmallBiz
stussy	ステューシー
famiglia	ファミリリア
breastcancerawareness	乳癌の意識
board	ボード
лайки	лайки
igerscatalunya	igerscatalunya
swan	白鳥
crocheting	かぎ針編み
baller	ボールラー
mocha	モカ
effect	効果
peterpan	ピーターパン
dogwalk	犬ウォーク
myedit	マイディット
bighair	馬小屋
nofear	恐怖
rates	料金
surrender	降伏
dressanak	ドレナナク
bazar	バザール
taxi	タクシー
slowmotion	スローモーション
iso	アイソ
tagblender	タグブレンダー
vk	vk
diabetes	糖尿病
teamnosleep	チームノーズスリープ
furnituredesign	furnituredesign
happy4th	ハッピー4th
grooming	グルーミング
happyshopping	楽しい買い物
cancersucks	癌人
crochetaddict	クロセタテディクト
jean	ジーンズ
christmasgift	クリスマスギフト
kittylove	kittylove
bajupesta	バジペスタ
goaldigger	ゴールディガー
bet	ベット
crybaby	赤ちゃんを泣き
potterhead	ポッターヘッド
espana	エスパナ
witty	気分
something	何か
vzla	vzla
asturias	アストゥリアス
movietime	映画の時間
artesanal	芸術的
40likes	40かかりつけ
tanktop	タンクトップ
cincodemayo	シンコデマヨ
творчество	творчество
classics	古典
calilife	カリシフェ
winnipeg	ウィニペグ
oppa	オパ
locs	ロース
getcreative	getcreative
dsseldorf	dsseldorf
engagementring	婚約指輪
badboy	悪ガキ
fusion	融合
americanbully	アメリカ人
firstdayofschool	firstdayofschool
penguin	ペンギン
crowd	群集
livelaughlove	リベラローブ
goodboy	グッドボーイ
originalcharacter	元の文字
brigadeiro	ブリガディロ
bellagio	ベルジャジオ
landrover	ランドローバー
ribbon	リボン
beyhive	ビーヒイブ
centro	セントロ
littlethings	ささいなこと
flowercrown	花かんむり
medicalmarijuana	医療大麻
fabshots	ファブショット
hotday	暑い日
nailartaddict	nailartaddict
brunomars	ブルーノ・マーズ
makeupart	メイクアップ
sore	痛み
gainparty	ゲインパーティー
dugun	ドゥグン
pazar	パザール
marmaris	マルマリス
content	コンテンツ
rak	ラーク
hairinspo	ヘアピン
безфильтра	безфильтра
grindout	粉砕
mas	マス
disneylandparis	ディズニーランドパリ
jualansepatu	ジュアンセプター
octopus	たこ
santos	サントス
shenanigans	嫌悪感
息子	息子
mike	マイク
ハロウィン	ハロウィン
momboss	モンボス
faithful	忠実な
textiles	テキスタイル
cotedazur	コトサール
spilledink	spilledink
awakening	目を覚ます
fuel	燃料
promoter	プロモーター
railway	鉄道
winery	ワイナリー
инстаграмнедели	инстаграмнедели
natureonly	自然のみ
reallove	本当の愛
puzzle	パズル
rural	農村
climb	登る
kuwaitinstagram	クワイットイングラム
fridays	金曜日
calvinharris	カルヴィン・ハリス
fashioninspiration	ファッションインスピレーション
ciclismo	シチスモ
followfollowfollow	フォローする
selfiesaturday	自家製の
p3top	p3top
hotrod	ホットロッド
engineer	エンジニア
bestbuds	ベストバディ
premiumquality	プレミアム品質
concertphotography	コンサートフォトグラフィー
親バカ	親バカ
casualstyle	カジュアルスタイル
gibson	ギブソン
agency	代理店
carspotting	キャスティング
divertimento	divertimento
trouble	トラブル
edmlifestyle	edmlifestyle
mm	mm
electronicmusic	電子音楽
revival	復活
wrap	ラップ
bikersofinstagram	バイカーの事例
deusnocontrole	デュノノコントロール
_	_
makeuplovers	makeuplovers
sao	サモ
wonder	ワンダー
nature_seekers	nature_seekers
kerala	ケララ州
komik	コミック
tiramisu	ティラミス
wynwood	ウィンウッド
yosemite	ヨセミテ
frenchriviera	フランスのリビエラ
aventador	アヴェンタドール
iceskating	アイススケート
belohorizonte	ベルリオゾン
libertad	リベルタッド
asianboy	アジアンボーイ
nikesb	ニケスブ
passione	パッシオーネ
normal	正常
planet	惑星
brideandgroom	新郎新婦
makemoney	マケモニー
desire	慾望
daddyslittlegirl	daddyslittlegirl
kansascity	カンザスシティー
sayings	言葉
simplelife	簡素な生活
planning	プランニング
shipping	運送
bestmoments	最高の瞬間
путешествия	путешествия
swedishgirl	swedishgirl
flowerstyles_gf	flowerstyles_gf
turndownforwhat	ターンダウン
rn	rn
chinesenewyear	中国語
sextou	セックストゥー
usedlikenew	中古リネン
sausagedog	ソーセージドッグ
harvest	収穫
abc	abc
blogueira	blogueira
дождь	дождь
turkobjektif	トルコブテクティフ
tasarm	tasarm
beautifulgirls	美しい女の子
justice	正義
ilustracion	ilustracion
progressnotperfection	進行不全
ipod	iPod
theknot	結び目
goldenhour	ゴールデンウィール
glowing	輝く
nachos	ナチョス
instafriend	インサフレンド
como	コモ
coupe	クーペ
burlesque	バーレスク
negro	ニグロ
babyphotography	ベビーフォトグラフィー
instaanimal	初期の
justindrewbieber	ジャスティンドリュービーバー
palms	手のひら
colazione	コラジオネ
fallowme	落ち着き
lebaran	レバラン
nicememe	ニセミム
choreography	振り付け
pacific	パシフィック
collaboration	コラボレーション
bomber	爆撃機
flatshoesmurah	フラットシューズムラ
ファインダー越しの私の世界	ファインダー越しの私の世界
торт	торт
about	約
rolemodel	ロールモデル
jewelrydesigner	ジュエリーデザイナー
jualdompet	jualdompet
jamtanganoriginal	ジャムタンガノリジナル
land	土地
mfw	mfw
nutricion	栄養
portfolio	ポートフォリオ
por	ポール
selfharmmm	セルフハーモム
math	数学
fato	ファト
second	二番目
feelingmyself	自分を感じて
otra	オトラ
bugununkaresi	バグンケンセレージ
sprayart	スプレー
beardlove	ひげそり
turin	トリノ
саратов	саратов
nolimits	無制限
fiftyshadesofgrey	fiftyshadesofgrey
tamojunto	タモジュント
gooutside	外に出なさい
structure	構造
supermoto	スーパーモト
animefan	アニメファン
noms	ノーム
sharefood	sharefood
aviary	鳥類
connecticut	コネチカット
canon6d	canon6d
aurora	オーロラ
oaxaca	オアハカ
taspesta	タペスタ
sheffield	シェフィールド
dirt	泥
farmhouse	農家
тренд	тренд
handcraft	手作り
funky	ファンキー
ss16	ss16
tacotuesday	tacotuesday
legitsellerph	法律家
amateur	アマチュア
anastasiabrows	アナスタシバブ
dragonballsuper	ドラゴンボールスーパー
holistic	ホリスティックな
bowl	ボウル
instagramaviation	インスペクション
soulfood	ソウルフード
flstudio	フルスタジオ
instaworld	instaworld
pudding	プリン
expression	表現
momo	モモ
wolverine	ウルヴァリン
baile	ベイリー
abundance	豊富
workingmom	ワーキングママ
нижнийновгород	нижнийновгород
bboy	bboy
cloudscape	クラウドスケープ
toms	トム
bazaaronline	バザロオンライン
dailyart	毎日
roomies	部屋
columbus	コルンバス
burjkhalifa	ブルジュ・ハリファ
momma	ママ
fashionmurah	ファッションムラ
louvre	ルーバー
withmylove	愛を込めて
provence	プロヴァンス
mondaymorning	月曜日の朝
iloveu	あなたを愛してます
люблюсвоюработу	люблюсвоюработу
surrealism	シュールレアリスム
nicepic	すてきな写真
1	1
illuminati	イルミナティ
psg	psg
adidasthailand	アディダスタイランド
bestdogever	最善の努力
studs	スタッズ
spoilt	甘やかされた
playita	プレイニタ
tees	ティー
zr1200	zr1200
cuddly	かわいい
president	大統領
adidasnmd	アディダス
ja	ジャ
kz	kz
blacksea	黒海
sundaynight	日曜日の夜
trains	列車
pinkfloyd	ピンク・フロイド
lisa	リサ
empower	力を与える
sa	sa
raybans	レイバン
abnehmen	アブニューマン
santodomingo	サントドミンゴ
chien	チェン
asianfood	アジア料理
vinho	ヴィンショ
potheadsociety	ポットヘッドサイエンス
viva	ビバ
katvond	カトコン
beardsofinstagram	beardsofinstagram
odontologia	歯科医院
alicante	アリカンテ
churchflow	教会の流れ
newcar	新車
cravings	欲求
hellaflush	こんにちは
nailpromote	爪の突起
visualart	ビジュアルアート
youandme	あなたと私
laceclosure	開封
homestyling	ホームステイ
findesemana	発見者
cleaning	クリーニング
innerpeace	内面
palettes	パレット
qualidade	資格
boanoitee	ボーイノイト
milwaukee	ミルウォーキー
dogumgunu	ドグムグヌ
hampers	邪魔する
sweatshirt	トレーナー
maker	メーカー
screenprinting	スクリーン印刷
iowa	アイオワ
bookme	bookme
gala	ガラ
miracle	奇跡
gulumseaska	ガルムセスカ
bigsister	ビッグシスター
brooklynbridge	ブルックリンブリッジ
streetphotographer	ストリートフォトグラファー
cinta	シンタ
nct	ナショナル
eats	食べる
facepaint	フェイスペイント
co	共同
wahl	ウォール
size	サイズ
biglove	大きな愛
specialized	特化した
bajuraya	バジュラヤ
tabbycat	タブビーキャット
strava	ストラバ
disneyparks	ディセンプ
fashions	ファッション
booze	酒
lineart	線画
vscoeurope	vscoeurope
rofl	ロルフ
bendiciones	ベンディオン
hayatandanibarettir	ハヤタンダンバレッタール
triumph	勝利
vapefriends	vapefriends
bora	ボラ
installation	インストール
judo	柔道
outsideisfree	外ではない
selebgram	セレブラム
cheerleader	チアリーダー
gymselfie	ジムジャーニー
erkekgiyim	エルケキイム
libra	聖書
floridalife	フロリダライフ
patrickstump	パトリックスタンプ
aries	牡羊座
location	ロケーション
tasmurmer	タスマーマー
roman	ローマ人
playadelcarmen	プレイデルカルメン
happythursday	幸せな日
hill	丘
fitfluential	フィット感
heartbroken	悲惨な
jusgramm	jusgramm
лайк	лайк
prasempre	プリムンプレ
bbggirls	bbggirls
cheetah	チーター
vscophilippines	vscophilippines
hapiness	幸せ
raiders	侵略者
feather	フェザー
blumen	ぼんやりした
onion	玉ねぎ
zapatos	サパトス
struggle	闘争
non	非
killer	キラー
90	90
bomdemais	ボメデ
slimmingworldfood	スリミングワールドフード
pirates	海賊
liguria	リグリア
loki	ロキ
solotravel	ソロトラベル
chrome	クロム
talk	トーク
cakedecorating	託す
cyclinglife	サイクリングライフ
noragami	ノルガガミ
fleurs	フリュール
torontolife	トロントライフ
brick	レンガ
brandedbag	ブランドバッグ
deliciousfood	おいしい食べ物
issue	問題
artworks	アートワーク
cigarette	シガレット
fin	フィン
brotherlylove	兄弟兄弟
pioneer	パイオニア
onedayatatime	オンデイトタイム
shell	シェル
fixie	解決策
cane	杖
mimi	ミミ
flat	平らな
savannah	サバンナ
partner	パートナー
powerlifter	パワーリフター
available	利用可能な
irm	irm
bobby	ボビー
lipsense	唇
blink182	blink182
bittersweet	ほろ苦い
wecute	メッセージ
extremecouponing	極限
yogajourney	ヨガジャニー
mykids	私の子供
novel	小説
nina	ニーナ
hermesbag	ヘルメスバッグ
jualkemeja	ジャルケメジャ
現貨	現金
instapup	インスタントアップ
del	デル
秋	秋
fitmoms	フィット感
pantipmarket	パンティップマーケット
worldtravel	世界旅行
kauai	カウアイ島
40	40
winchester	ウィンチェスター
ootdmen	おとぎ話
justkidding	冗談だ
xspromoter	xspromoter
bourbon	バーボン
ghana	ガーナ
likelikelike	likelikelike
panamacity	パナマ市
neverquit	決してない
indiapictures	インディビュー
um	um
vtec	vtec
grinding	研削
dreamscometrue	dreamscometrue
glassart	グラスアート
прическа	прическа
uber	ユーバー
mentor	指導者
jerusalem	エルサレム
qtr	qtr
coffeeholic	コーヒー
tiu	ティウ
myfriends	私の友人
maskerwajah	マスカーワジャ
halsey	ハルシー
vegeta	植物
some	一部
frase	frase
superheroes	スーパーヒーロー
aqua	アクア
goldengatebridge	ゴールデンゲートブリッジ
gore	ゴア
mainananak	メインナナク
tiedye	タイダイ
sunflowers	ヒマワリ
bajucewekmurah	バジュズヴェクラフ
invest	投資する
likeforcomment	likeforcomment
restday	休日
crafting	工作
парк	парк
feature	特徴
nana	ナナ
instaaaaah	インストラクター
pinay	ピンチ
press	押す
vessel	容器
tomboy	おとぎ話
igerslondon	igerslondon
sud	スード
disciplina	規律
guam	グアム
irma	irma
vscogallery	vscogallery
dowork	仕事する
direito	ディリート
ciel	シエル
mannequinchallenge	マネキンチャレンジ
jewelrydesign	ジュエリーデザイン
chocolatelab	ショコラテラブ
vegetable	野菜
spartanrace	スパータンレース
praise	賞賛
tattooing	刺青
mockingjay	モッキングジェイ
jafra	ジャフラ
lastyear	昨年
justmarried	新婚
pjs	pjs
itsthelittlethings	それは、
dablife	ダブライフ
distro	ディストリビューション
arch	アーチ
foggy	霧の
chili	チリ
souvenirs	お土産
bayangiyim	ベイヤンギム
lovethisgirl	恋人
historia	歴史
fallcolors	フォールカラー
instaflowers	インスタントフラワー
hublot	ウブリ
loveforever	永遠の愛
doityourself	doityourself
mouth	口
tlv	テレビ
mit	ミット
eyecandy	目の保養
bienestar	バイネスタ
profile	プロフィール
tiesto	ティエスト
golook	ゴロック
lg	lg
bergen	ベルゲン
cider	サイダー
highlighter	蛍光ペン
bajulebaran	バジュレバラン
shotoniphone	ショトニホン
igglobalclub	igglobalclub
jellyfish	クラゲ
foodtrip	食べ物
dirtbike	ダートバイク
catchingfire	キャッチファイア
teachersfollowteachers	teachersfollowteachers
practiceandalliscoming	練習と会合
chilled	冷たい
toystagram	トゥイスグラム
myhusband	私の夫
allnatureshots	allnatureshots
nursing	看護
instabeard	instabeard
quinoa	キノア
dive	潜水
barbering	野蛮
calledtobecreative	呼び出される
apaixonada	アピックスナダ
wisuda	ウィスダ
inspiracao	インスピラカオ
ngakakkocak	ナガカコカク
daytrip	日帰り旅行
tlpicks	tlpicks
cloudchasing	クラウジング
nikon_photography_	nikon_photography_
blackandgreytattoo	ブラックアンドグレイトタトゥー
nakedplanet	裸の平面
hannover	ハノーファー
niagarafalls	ナイアガラの滝
bismillah	ビスティラ
shadowhunters	シャドウハンター
ponytail	ポニーテール
quartz	石英
snowflakes	雪片
printing	印刷
bulldogfrances	ブルドッグフランシス
sepatusport	sepatusport
retrato	レトラート
reception	受信
devon	デボン
модно	модно
streetview	ストリートビュー
australiagram	オーストラリアの図
linkinpark	リンクインパーク
conceptart	コンセプトアート
wicked	邪悪な
sotd	sotd
riga	リグア
huskylove	ハスキリヴ
wigs	かつら
loft	ロフト
supergirl	スーパーガール
thankyoujesus	感謝祭
dinahjane	ディナヒャン
naturalista	ナチュラルスタジオ
eotd	eotd
behealthy	健康になる
awesome_shots	awesome_shots
instagraff	インガグラフ
psychology	心理学
eyebrowsonfleek	眉毛フリルク
gaycute	ゲイテ
jp	jp
riseandshine	ライズアンドシャイン
touring	ツーリング
chanelthailand	シャネルタイランド
papi	パピ
wonderlust	不思議
graciasdios	グラシアディオス
khloekardashian	クルーカーダシアン
jawa	ジャワ
peaceofmind	心の平和
narry	ナリー
nailartclub	ネイルクラブ
iftar	iftar
lunchbreak	昼休み
blackpower	ブラックパワー
косметика	косметика
sapporo	札幌
williamsburg	ウィリアムズバーグ
oysters	カキ
bengal	ベンガル
empirestatebuilding	エンパイアステートビル
gamisset	ガニセット
manaus	マナウス
womens	婦人向け
nycprimeshot	nycprimeshot
jualgamis	ジャルガミス
etsyfinds	etsyfinds
denizli	デニズリ
purr	パル
bici	ビシ
selfiequeen	セルフクイーン
tattooer	入れ墨
solenation	ソレネーション
instarunner	インスタルナー
наращивание	наращивание
mikeyway	マイキーウェイ
saturdays	土曜日
rsa_minimal	rsa_minimal
margaritas	マルガリータ
leggo	レゴ
jenniferlawrence	ジェニファーローレンス
gayuk	ガユク
alba	アルバ
tx	tx
floor	床
shoegasm	ショーガス
big_shotz	ビッグショット
belfast	ベルファスト
novosibirsk	ノボシビルスク
jualbatik	ジュールバティック
dw	dw
travelgirl	旅行ガール
insects	昆虫
af	af
londres	londres
snacktime	おやつの時間
instabooks	事務所
femme	女性
confused	混乱した
girlswhosmoke	ガールズウィズモスク
cowboysnation	カウボーイシネーション
lindy	リンディ
braziliangirl	ブラジルの女の子
photograpy	フォトグラフィー
gohawks	ゴーホーク
saudavel	サウダベル
bond	ボンド
encorebeachclub	アンコールバッククラブ
ucl	ucl
19	19
caroftheday	カロフディーディー
androidography	アンドログラフィック
sweet16	スイート16
gunsnroses	ガンズ・アンド・ローゼズ
chia	チア
yogaaddict	yogaaddict
модель	модель
maria	マリア
the6ix	the6ix
lucas	ルーカス
jualbajuimport	ジュールバジャイポート
hash	ハッシュ
insta_pick_blossom	insta_pick_blossom
cannabisculture	カンナビカルチャー
сумка	сумка
ig_eurasia	ig_eurasia
gone	行った
dogsandpals	犬とパンパル
blackdress	黒いドレス
austinmahone	オースティン・マホーン
lululemon	ルルレモン
firstborn	先生
parenthood	親父
jualaksesoris	ジュリアクセスリス
artdeco	アールデコ
freeride	フリーライド
nastybarbers	ナイスバーバー
spaniel	スパニエル
hyundai	現代
guinness	ギネス
hohoho	ほほほ
choices	選択肢
gethealthy	元気になる
tumblrtextpost	tumblrtextpost
waterfoam	水の泡
countryboy	田舎の少年
ig_great_pics	ig_great_pics
boyband	ボーイ・バンド
petewentz	ペットワインツ
seni	セニ
pewdiepie	ピューディエピ
empty	空の
moneyteam	マネーティム
manizales	マニサレス
ct	CT
pleasure	喜び
bankholiday	銀行休暇
souvenirultah	記念碑
vscom	vscom
vscolover	vscolover
elvis	エルヴィス
cardiganmurah	カーディガンムラ
funnyface	面白い顔
catslover	キャットオーバー
makeuplove	makeuplove
herb	ハーブ
60s	60年代
makan	マカン
juju	ジュジュ
bridalhair	ブライダルヘア
vehicles	乗り物
breaktime	休憩時間
invierno	インビエント
preto	プレオ
viking	バイキング
ladyboss	女上司
kuwaitcity	クウェートシティ
juicy	ジューシーな
shopnow	買い物
luckywelivehawaii	ラッキーウェリヴァワイイ
homecooked	自宅にいる
blackberry	ブラックベリー
genova	ジェノバ
tahoe	タホ
casting	鋳造
стильно	стильно
ig_israel	ig_israel
ilovevegas	ilovevegas
lesson	レッスン
takemehome	家まで連れて帰ってください
tofu	豆腐
artforsale	アートフォールズ
slow	スロー
capecod	キャプコッド
jamtanganwanita	ジャムタンガンワニタ
permanentmakeup	パーマネントメークアップ
sucks	吸う
seaview	海の眺め
wannaone	ワナホン
livro	リヴロ
corridaderua	コリドーデュア
bileklik	胆石
kasutmurah	カツフラ
squishy	かすかな
rouge	ルージュ
minho	ミンホ
parabns	パラブス
spoiler	スポイラー
dakotajohnson	ダコタジョンソン
ioete	ioete
buzzfeed	バズフィード
hrnyrp	hrnyrp
keepsmiling	維持管理
365	365
symmetry	対称
sunnah	サンナ
huskiesofinstagram	ハスキーズの事例
sfgiants	スフィアンツ
euquero	ユーケロ
letthekids	Letthekids
originalart	オリジナルアート
choco	チョコ
pisces	魚座
farming	農業
tenis	テニス
sixflags	シックス・フラッグス
watchoftheday	watchoftheday
offwhite	オフホワイト
audio	オーディオ
olaf	オラフ
commitment	コミットメント
mybrother	私の兄弟
childhoodmemories	子どものころの思い出
sxsw	sxsw
granola	グラノーラ
photographers_tr	photographers_tr
allybrooke	アリーブルック
snapchatfilter	snapchatfilter
birthdaypresent	誕生日プレゼント
80	80
peacock	孔雀
cas	カス
fortlauderdale	Fortlauderdale
expensive	高価な
redneck	卑しい
shimano	シマノ
campaign	キャンペーン
itswhitenoise	そのホワイトニング
parkchanyeol	パークチャネオール
楽しかった	楽しかった
aj	AJ
goodfriday	良い金曜日
livefolkindonesia	ライブフォンインディアニア
jasaiklan	ジャスキュラン
bouldering	ボルダリング
hellyeah	ヘイリーア
vestidos	ヴェスティド
essex	エセックス
jelly	ゼリー
trinidad	トリニダード
newme	新しい私
princesas	プリンセスサ
personaldevelopment	自己啓発
idubbbz	イデューブズ
ig_cameras_united	ig_cameras_united
schweiz	シュウェイズ
fridakahlo	フリダーカフロ
successquotes	成功票
check	チェック
часы	часы
trout	マス
getoutdoors	getoutdoors
bugs	バグ
mission	ミッション
felices	フェリックス
ruins	遺跡
blingbling	ケバケバ
bruxelles	ブリュッセル
poppunk	ポップン
forex	外国為替
glamorous	グラマラス
instasyon	インスタント
rihannanavy	リハナンビー
project365	プロジェクト365
testimonial	証言
nerds	オタク
everydaycarry	毎日のキャリー
tudung	道
tw	tw
benedictcumberbatch	ベネディクト・カンバーバッチ
herewego	さあ
sooyoung	ソヨング
platinum	白金
dressedup	ドレスアップして
bk	bk
benchpress	ベンチプレス
sepatuvans	Sepatuvans
бижутерия	бижутерия
emagrecimento	emagrecimento
canta	カンタ
newseason	新しい季節
bestmoment	ベストモーメント
визажист	визажист
kulinerjakarta	クライネジャカルタ
ayakkab	アヤック
praying	祈る
feelingblessed	祝福された感じ
jualkalung	ジュールカルン
jaipur	ジャイプール
nigth	ニグス
hetalia	ヘタリア
fitment	装備
vscospb	vscospb
tights	タイツ
nederland	オランダ語
fashiontrends	ファッショントレンド
born	うまれた
charger	充電器
dronestagram	ドロネーグラム
widn	ウィン
kecantikan	ケカンティカン
pho	フォ
glock	グロック
publicidad	publicidad
latvia	ラトビア
lille	リール
wasted	無駄な
babywearing	ベビーウェア
healty	ヒーリング
666	666
bullybreed	いじめられた
icant	私はできません
homestuck	ホームステイ
nian	ニアン
homosexual	同性愛者
photographs	写真
jiyong	ジヨン
plannerlove	プランナーローブ
liveoutdoors	ライブアウトドア
outing	外出
mess	混乱
wroclaw	ブロツラフ
pensieri	ペンシエリ
fenerbahce	フェネルバフチェ
dametraveler	設計者
inside	内部
sake	酒
selfiestick	セルフスティック
nikeshoes	ニケショーズ
caseiphone5	caseiphone5
weddingtime	結婚式の時間
reptiles	爬虫類
sanjuan	三元
италия	италия
oldskool	oldskool
jawabarat	ジャワバラット
21st	21日
clash	衝突
mansion	大邸宅
deadlifts	デッドリフト
赤ちゃん	赤ちゃん
екб	екб
vibrant	活気のある
montecarlo	モンテカルロ
hippy	ヒッピー
molly	モリー
browsonfleek	browsonfleek
july4th	7月4日
goodweather	いい天気
hotels	ホテル
cadillac	キャデラック
topvsco	トップスコ
500px	500ピクセル
eagles	イーグルス
fashionbaby	ファッションベイビー
blackwomen	黒人
тепло	тепл_
strikeapose	ポーズをとる
gayhunk	ゲイハンク
jawatengah	ジャワテンガ
photogenic	フォトジェニック
cbr	CBR
decemberphotochallenge	12月写真撮影
kidswear	子供服
prettyfeet	かわいい
godislove	神は愛である
morningwalk	朝の散歩
igs_photos	igs_photos
jordandepot	ヨルダンペポ
auguri	オーギュリ
mississippi	ミシシッピ
instasun	インスタント
_	_
tasmania	タスマニア
semester	学期
essence	エッセンス
bale	ベール
jeansmurah	ジーンズムラ
ужин	ужин
caradelevingne	カーデレービングン
channel	チャネル
写真好きな人と繋がりたい	写真好きな人と繋がりたい
roadtrippin	ロードトリップ
gaybeard	ゲイビアード
elle	エル
plannercommunity	プランナーコミュニティー
basil	バジル
familyphotography	家族写真
rappers	ラッパー
smackdown	叱責する
homecook	ホームクック
likeforshoutout	likeforshoutout
valley	谷
national	全国
heroes	ヒーロー
hustlehard	ハードハッスル
marka	マーク
instahorse	インストゥルメン
promocao	プロポカオ
daytime	昼間
др	др
vocalist	ボーカリスト
holy	聖なる
cagliari	カリアリ
beyaz	ベヤズ
イラスト	イラスト
irox_bw	irox_bw
доченька	доченька
vintageclothing	古着
gymnast	体操選手
petitejoys	ペット
dg	dg
vday	vday
streetshot	ストリートショット
marker	マーカー
малыш	малыш
awards	賞
tongsis	トンジー
istagood	istagood
ouat	オアフ
algarve	アルガルヴェ
movember	ムンベリ
sleeve	スリーブ
chennai	チェンナイ
vapefamily	vapefamily
bnwphotography	フォトグラフィー
thatface	あの顔
chandelier	シャンデリア
bullylove	バリーロブ
lebanese	レバノン語
happymoment	幸せな瞬間
atm	気圧
wooden	木製
livelovelaugh	livelovelaugh
know	知っている
unhasdasemana	アンハスダマネア
pin	ピン
fotografo	fotografo
felt	フェルト
ev	ev
southern	南方の
empreendedorismo	empreendedorismo
_	_
brazilianjiujitsu	ブラジリアンジュージュ
missthem	間違った
citykillerz	シティキラーツ
veganlifestyle	ビーガンライフスタイル
guapo	ガポ
fleur	フール
hijaboutfit	hijaboutfit
stayhumble	謙虚であれ
lovemyboys	ラブミーボーイズ
taco	タコス
rsa_ladies	rsa_ladies
helicopter	ヘリコプター
okc	okc
dolantwins	憂鬱
рисунок	рисунок
ketogenic	ケトン生成性の
likeforfollows	likeforfollows
simpsons	シンプソンズ
etudehouse	エチュードハウス
instamotogallery	インスタントギャラリー
shoesoftheday	靴を履くこと
visitindonesia	訪問インドネシア
subie	サブ
guitars	ギター
bizzle	狂った
atv	テレビ
hiphopmusic	ヒップホップミュージック
baobao	バオバオ
instaaddict	インストラクター
foodaddict	食品添加物
photographerlife	フォトグラファー
ari	アリ
yyz	yyz
sobeautiful	とても美しい
oldfriends	古くからの友人
haiti	ハイチ
mensfashionpost	mensfashionpost
malaysiaonlineshop	マレーシアラインショップ
indonesia_photography	インドネシアの写真
bestofday	ベストフーデー
dolphins	イルカ
havana	ハバナ
кроссовки	кроссовки
graphite	黒鉛
francia	フランシア
likeforafollow	likeforafollow
tattooedgirl	タトゥー・ガール
jacksonville	ジャクソンビル
vegangirl	vegangirl
darkhair	ダークヘアー
staycation	滞在
vegano	ビーガノ
иркутск	иркутск
ink361	インク361
furla	フルラ
калининград	калининград
veracruz	ベラクルス
punjab	パンジャーブ
котэ	котэ
bajubkk	バジャクク
financialfreedom	経済的自由
buhi	ブヒ
pre	前
riseup	立ち上がる
tesetturgiyim	テゼトゥグギイム
jaredleto	ジャレレット
lads	若者
monsters	モンスター
eatfamous	食べる
instashare	instashare
var	var
hermosas	ヘルモサ
problems	問題
myhappiness	私の幸せ
freeway	高速道路
裙	裙
dontjudge	dontjudge
pakaianwanita	パカイアワニタ
layers	層
jamcouple	ジャムカップル
nagoya	名古屋
fleek	卑劣な
vansmurah	バンズラウ
tickets	切符売場
battle	戦い
macro_perfection	マクロ・パーフェクション
note	注意
zodiac	十二支
throw	スロー
lovemusic	音楽が大好き
drop	ドロップ
bridestory	ブリヂストン
lunchdate	昼食
gtafive	オファフィーブ
fineartphotography	小型写真
тренировка	тренировка
jaketcowok	ジャケットコウォク
cave	洞窟
catalonia	カタロニア語
sexyboy	セクシーボーイ
happykids	ハッピーキッズ
dekor	デコル
hkgirls	hkgirls
photographylover	フォトオーバー
polymerclay	ポリマークレイ
anorexiarecovery	食欲不振
buzzfeedanimals	バズフィードマニア
teaching	教える
vinyligclub	ビニールクラブ
coldweather	寒波
xiaomi	xiaomi
vin	ヴィン
buddhism	仏教
plantpower	植物力
poppy	ポピー
letgo	手放す
autunno	オートノー
topdogphoto	トップドッグフォト
splendid_shotz	splendid_shotz
jdmgram	jdmgram
amateurphotography	アマチュアフォトグラフィー
cucuta	ククタ
womenempowerment	女性のエンパワーメント
meet	会う
campus	キャンパス
timeless	時を超えた
yas	ヤス
impreza	インプレッサ
rapunzel	ラツーンゼル
педикюр	педикюр
safe	安全
parabens	パラベン
cutekidsfashion	かわいいファッション
bajufashion	バジュファッション
vscomalaysia	vscomalaysia
kim	キム
tourists	観光客
sneakershouts	スニーカーショーツ
savethedate	日付を保存
bnw_globe	bnw_globe
catania	カタニア
supercell	スーパーセル
azerbaycan	アゼルバイジャン
feria	フェリア
travellers	旅行者
pemutihkulit	ペムティクリット
greattimes	素晴らしい時間
yoda	ヨーダ
sana	サナ
knockout	ノックアウト
martini	マティーニ
westernaustralia	ウェスタンオーストラリア
hdr_pics	hdr_pics
bibleverse	バイブル
giveback	返済
gamiskatunjepang	ガンマスキージャンパン
fitlifestyle	フィットライフスタイル
cirebon	シレボン
кошка	кошка
explorebali	エクスプローバ
presentededeus	提示された
tongsismurah	トングシスラ
инстаграманет	инстаграманет
motherandson	母と息子
singlerp	シングルラップ
push	押す
onlineshopbandung	オンラインショップバンドン
jualkacamata	ジャカルカママタ
jade	ヒスイ
waterfront	ウォーターフロント
kidslookbook	kidslookbook
美容	美容
sepaturunning	セパツニング
stilesstilinski	Stilesstilinski
bajutidur	バジューダール
sweetgirl	スウィートガール
blurry	ぼやけた
instafame	イスタンブール
practicemakesperfect	練習問題
zoom	ズーム
minhaprincesa	最小限度
loveanimals	愛のイニシャル
vista	ビスタ
aquarius	アクアリウム
кино	кино
letter	文字
kill	殺します
mauritius	モーリシャス
myrtlebeach	マートルビーチ
sweetpotato	スイートポテト
justforfun	ジャストフォーファン
cavs	キャブ
ayodolan	アヨドラン
ig_shutterbugs	ig_shutterbugs
сын	сын
suisse	スイス
analogue	アナログ
restinpeace	安らかに眠る
myqueen	私の女王
poolday	プールの日
jawatimur	ジャワティムール
milo	ミロ
lovethisplace	愛する人
biscuits	ビスケット
creativityfound	創造性の発見
gne	グネ
hairy	毛深い
divine	神聖な
tigers	トラ
mohawk	モホーク
champ	チャンピオン
carbon	炭素
lds	lds
bwstyleoftheday	bwstyleoftheday
amanecer	アマネカー
vscovisuals	vscovisuals
ofmiceandmen	ofmiceandmen
女の子	女の子
zr1500	zr15__00
sgfood	sgfood
fatcat	太った猫
marley	マーリー
360	360
музыка	музыка
lil	リル
oscars	オスカー
beetle	甲虫
atacado	アタカド
archery	アーチェリー
doodlesofinstagram	事例
vscogoodshot	vscogoodshot
picture_to_keep	picture_to_keep
filhos	フィロス
tasjakarta	タジジャカルタ
otoo	オットー
momtobe	母親
bigapple	ビッグアップル
jualjaket	ジュリアジャケット
ジェルネイル	ジェネラル
featurepalette	フィーチャーパレット
makeupobsessed	makeupobsessed
hardcase	ハードケース
shitzu	シツ
sonya6000	ソニア6000
barefoot	裸足
pinupgirl	ピンポンガール
meistershots	マイスターショット
sexybeast	セクシービースト
lovemygirls	ラブミーガールズ
ipsy	ipsy
mypet	私のペット
yngkillers	ヨンキラー
bayram	バイラム
chihuahuas	チワワ
sweetie	恋人
memorial	記念碑
emagrecer	emagrecer
detalhes	衰弱
gundam	ガンダム
snooze	スヌーズ
goodcompany	良い会社
rodeo	ロデオ
hyoyeon	ヒョヨン
celanakulot	セラナクロット
reggaeton	レゲトン
snapsave	スナップ
booklove	書籍
skeletonclique	スケルトンクラス
bicicleta	ビシッレッタ
jumpsuitmurah	ジャンプスーツムラ
perros	ペロス
archdaily	archdaily
danish	デンマーク語
shootermag	銃撃戦
animalkingdom	アニマルインゴム
feed	フィード
cibo	シボ
monogram	モノグラム
dailylife	デイリーライフ
palmbeach	パームビーチ
bondi	ボンディ
musculacao	ムスクラカオ
dicas	ジカス
yep	うん
danmark	ダンマーク
batiktulis	バティック
nxt	nxt
gamerguy	ガンガルー
entrepreneurlifestyle	起業家スタイル
trapmusic	音楽を罠にかける
krabi	クラビ
well	よく
suarez	スアレス
befree	自由になれ
huntingtonbeach	ハンチントンビーチ
midwest	中西部
hargamurah	ハガムラ
maromba	マロムバ
nightshift	夜遊び
newstyle	新しいスタイル
oasis	オアシス
boatlife	ボートライフ
brewery	醸造所
everywhere	どこにでも
fisioterapia	フィジオテラピア
crossstitch	クロスステッチ
808	808
pembesarpayudara	Pembesarpayudara
suitup	スーツアップ
mystery	神秘
cnd	cnd
мимими	мимими
troll	トロール
vapesociety	賞賛
lilo	リロ
kidsroom	子供部屋
pencilart	鉛筆
meutudo	メトード
northshore	ノースショア
budlight	蛍の光
mist	ミスト
phonecase	フォネケース
cores	コア
summerfashion	夏のファッション
realestateagent	不動産業者
almost	ほぼ
asparagus	アスパラガス
ali	アリ
churras	チャラス
taurus	おうし座
una	ウナ
sweetness	甘味
grafitti	落書き
newportbeach	ニューポートビーチ
bosslife	ボスライフ
ямама	ямама
citytrip	都市旅行
dripclub	ドリップクラブ
products	製品
aaa	aaa
guapos	ガポス
весело	весело
fashionmen	ファッションマン
облака	облака
parfummurah	パフュムマーラ
hairporn	ヘアポーリン
dailyfluff	毎日のフラフ
birthdaycelebration	誕生日のお祝い
gotham	ゴッサム
finedining	高級料理
slipknot	スリップノット
lovelive	愛らしい
indoor	屋内
ajman	アジマン
ms	ミズ
hungover	hungover
ifb	ifb
winterfashion	冬のファッション
logan	ロガン
hybrid	ハイブリッド
artfido	アートフィード
nonbinary	非バイナリ
skateeverydamnday	スケベイダンスダンス
moodyports	ムーディースポーツ
男の子	男の子
microsoft	マイクロソフト
britain	英国
wishlist	ウィッシュリスト
weihnachten	Weihnachten
freshcut	フレッシュカット
miamilife	マイアミライフ
ふわもこ部	ふわもこ部
merryxmas	メリークリスマス
midcentury	ミッドセンチュリー
jualbajuanak	ジュールバジャナク
minimalistic	ミニマル
dallascowboys	ダラスカウボーイ
hijabcantik	ヒジャーブンキン
nostress	ストレスがない
распродажа	распродажа
веселье	веселье
ar15	ar15
unstoppable	止まらない
衫	衫
maknae	マクネ
suju	スジュ
breakfasttime	朝食の時間
igotthis	私はこれを得た
newport	ニューポート
simba	シムバ
saree	サリー
doors	ドア
アクセサリー	アクセサリー
research	研究
обед	обед
200likes	200likes
daniel	ダニエル
riders	ライダー
forsaleph	forsaleph
sahabat	サバハット
beautifulsky	美しい空
television	テレビ
gaysexy	ゲイセクシー
cabin	キャビン
coworkers	同僚
an	〜
wyoming	ワイオミング
stuffed	つめた
thirdeye	ティルダイ
david	デビッド
actitud	物語
maybe	多分
almoo	アルムー
lincoln	リンカーン
openhouse	オープンハウス
инстатаг	инстатаг
donghae	東海
kurus	クルス
bookphotography	ブックフォトグラフィー
longboarding	ロングボード
stylediaries	スタイルスタディ
pumped	ポンピングされた
woo	うん
babyface	童顔
textile	繊維
itsmybirthday	それは私の誕生日です
sailor	船員
capri	カプリ
zulia	ズリア
tunnel	トンネル
littleboy	リトルボーイ
likemypic	好きな
feline	猫
humour	ユーモア
iifymgirls	iifymgirls
casablanca	カサブランカ
corsica	コルシカ
himmel	ヒメル
crack	亀裂
upcycle	アップサイクル
godisgreat	神は偉大だ
dinnerdate	ディナーデート
chakra	チャクラ
siyah	シヤ
potrait	養殖場
luffy	ルフィ
girlsweekend	ガールズウィークエンド
apink	アピンク
johnnydepp	ジョニーデップ
motheranddaughter	母と娘
side	側
hypercar	ハイパーカー
blacktattoo	ブラックタトゥー
whitecat	白い猫
activewear	アクティブウェア
aile	アイル
montagna	モンタナ
bestfriendsforever	bestfriendsforever
gamispesta	ガミスペスタ
descobreixcatalunya	descobreixcatalunya
classmates	同級生
md	md
killinit	殺人犯
headshot	ヘッド・ショット
rangerover	レンジローバー
johnlennon	ジョン・レノン
glory	栄光
bilbao	ビルバオ
blackout	ブラックアウト
deathmetal	デスメタル
gratis	無償
foodism	食べ物
architettura	アーキテクチュア
holi	聖
balticsea	バルチック
guapa	グアパ
sammyprincess	サンプリンクリーム
christmas2014	christmas2014
sleevetattoo	スリベットトート
amazingday	素晴らしい日
growinguptoofast	成長期
diversion	流用
uncalculated	未計算
_	_
handtattoo	ハンドタトゥー
sueo	スエオ
pacificocean	太平洋
goldsgym	ゴールドジム
babyclothes	ベビー服
morningrun	モーニングラン
2008	2008年
instapug	祈る
justbecause	ただの理由から
thaishop	タイショップ
editoftheday	編集の日
dreamcar	夢のような車
funnyfaces	面白い顔
wakacje	ワカッチェ
penggemuk	ペンゲムク
dirtyrp	dirtyrp
flip	フリップ
supper	晩餐
artlover	アートオーバー
actionfigures	アクションフィギュア
friendly	フレンドリーな
sandy	砂の
doyouevenlift	持ち上げたりさえするの
indianfood	インド料理
rostov	ロストフ
fuckyeah	ファックイア
espn	espn
juicing	搾っている
diecast	ダイキャスト
plan	計画
redhairdontcare	レッドヘアドレッサー
triathlete	トライアスロン
shihtzusofinstagram	Shihtzusofinstagram
ornaments	装飾品
enak	エナク
seaworld	シーワールド
parka	パーカー
lebronjames	レブロンジェームズ
raytoro	レイトーロ
tire	タイヤ
mina	ミナ
igersbcn	igersbcn
sahil	サヒル
gamisanak	ガミサナク
followmeback	私の後ろについてきて
naturalmakeup	ナチュラルメークアップ
sapphire	サファイア
chanbaek	チャンベク
hilton	ヒルトン
smores	煙草
pizzahut	ピザハット
mondayblues	月曜日のブルース
jet	ジェット
raidernation	侵略
jerseyshore	ジャージーショア
igersmilano	イゲルスミラーノ
ninadobrev	ニーナ・ドブレフ
m4	m4
myidol	私のアイドル
mermaidhair	マーメイドヘア
falcon	ファルコン
despedida	デスペディダ
amv	amv
chemistry	化学
pothead	ポットヘッド
lovedit	楽しかった
cavalierkingcharlesspaniel	騎士団
louisville	ルイスヴィル
lotr	Lotr
sarcasm	皮肉
feitoamao	フィアママオ
swiftie	迅速に
carbonfiber	カーボンファイバー
moldiv	モンゴル
girlsbestfriend	girlsbestfriend
jedi	ジェダイ
9мая	9ヶ月
instalive	据え付け
electric	電気の
performer	出演者
copacabana	コパカバーナ
priorities	優先順位
cabincrew	キャビンクルー
bullylife	いじめ
herbalifenutrition	薬草栄養
dogphotography	犬の写真
absaremadeinthekitchen	忘れることのないキッチン
outer	アウター
vivalavida	ビバラダ
арт	арт
central	中央
andis	そして
lfw	lfw
visualoflife	visualoflife
viaggio	ヴィアッジョ
algeria	アルジェリア
brushlettering	ブラシレターニング
instasquare	instasquare
35mmfilm	35mmフィルム
beaglesofinstagram	ビーグルズオブインスターグラム
ldr	ldr
gypsysoul	ジプシー
lionking	ライオンキング
wristporn	リストラ
unik	ユニック
artstudio	アートスタジオ
шоппинг	шоппинг
pisa	ピサ
writerscommunity	作家コミュニティー
adventureisoutthere	アドベンチャーアウトレット
churrasco	シュラスコ
mums	お母さん
icaniwill	できるやるわ
promoteolshop	プロモーションショップ
spray	スプレー
cyclist	サイクリスト
iloveny	ニューヨークが大好き
dubaifashion	デュバファッション
jlo	ジュロ
spettacolo	スペッテコロ
followyourdreams	夢を追え
tokoonline	トークンライン
iheartawards	私は
byefelicia	バイフェリシア
smokeweedeveryday	マリファナを毎日吸う
christianity	キリスト教
background	バックグラウンド
taskulit	タスクラット
compartir	コンパートメント
vilnius	ビリニュス
vitamin	ビタミン
ilovemyfamily	私は家族を愛しています
midtown	ミッドタウン
modified	変更された
oceanview	オーシャンビュー
insieme	インシエム
treatyourself	treatyourself
khv	KHV
exploretheworld	世界を探検する
ew	ew
aplacetolovedogs	面白い犬
sen	セン
perthisok	ペリチソク
felicit	肯定的な
damat	ダマット
creature	生き物
spartan	スパルタン
chaps	チャップス
producers	生産者
tall	背の高い
sista	シスタ
branco	ブランコ
hkfoodie	hkfoodie
leg	脚
kaospolos	カオスフォロス
theend	終わり
singlemom	シングルマザー
bubble	バブル
biology	生物学
igersaustria	igersaustria
portoalegre	ポルトアレグレ
paypal	ペイパル
obatdiet	Obatdiet
berry	ベリー
kindle	ライト
pepsi	ペプシ
raindrops	雨滴
godfirst	ゴッドファースト
代購	代謝
yogagram	ヨーグラム
wanderfolk	放浪者
тату	тату
penandink	ペンとインク
girltime	ガールタイム
cobra	コブラ
fitfrenchies	フィットファインズ
veg	veg
barefeet	はだし
beardeddragon	フトアゴヒゲトカゲ
sketchaday	スケッチ
sanfran	サンフラン
trening	トレニング
футбол	футбол
stream	ストリーム
kedah	ケダ
labradoodle	ラブラドール
yellowlab	イエロー
mariage	結婚
allahuakbar	アッラーハババー
astro	アストロ
cosmetology	化粧品
sparkly	輝く
tj	tj
igmilitia	igmilitia
artofinstagram	美術館図
smoothies	スムージー
dub	ダブ
cocina	コシナ
togetherforever	永遠にともに
mardigras	マルディグラス
perak	ペラペラ
promise	約束する
historical	歴史的
sleeptime	睡眠時間
ferry	フェリー
surfboard	サーフボード
tr35	tr35
stunning_shots	stunning_shots
instamoto	インスタント
joshua	ジョシュア
urbanstyle	都会的なスタイル
planes	飛行機
guilty	有罪
derby	ダービー
forza	フォーサ
moose	ムース
uas	あなた
eunhyuk	はんゆク
runnerscommunity	ランナーズコミュニティ
communityovercompetition	コミュニティオーバーカミング
sepatuboots	sepatuboots
byunbaekhyun	バイベクヒョン
nervous	神経質な
gordice	ゴルド
makersmovement	メーカーの動き
teal	ティール
gunporn	ガンポン
leeminho	イ・ミンホ
rize	リーズ
omnianightclub	オムニアライトクラブ
treasure	宝
北海道	北海道
ilovenorway	ilovenorway
vitaminsea	ビタミン剤
cuteanimals	かわいいアニメ
rolltide	ロールオフ
luckyme	私は幸運
dadlife	お父さん
getsome	いくらか得る
dresden	ドレスデン
igreads	igreads
ziam	ジアム
soinlove	深く愛し合って
instamillion	インスタントリーム
veteran	ベテラン
montagne	モンタニー
1989	1989年
kharkov	カハロフ
sofun	とても楽しいです
masker	マスカ
grammasters3	文法師3
niceweather	いい天気
steampunk	Steampunk
paul	ポール
jamtanganbranded	ジャムタンガンブランド
eyelash	まつげ
tashermes	おしゃべり
goodvibe	いい感じ
australian	オーストラリア人
vscoua	vscoua
matrix	マトリックス
powerstroke	パワーストローク
scandinavian	北欧の
athletic	運動
kendricklamar	ケンドリックラマー
jualrok	ジャロロク
another	別の
beste	ベスト
ultraboost	ウルトラブースト
conference	会議
estonia	エストニア
fashionkilla	ファッションキラー
makeupwisuda	メイクアップウィスダ
thankyougod	神様ありがとう
girlswhosquat	ガールズホースクワット
luxuryrealestate	豪華な現実
challenger	挑戦者
legionofboom	legionofboom
деньги	деньги
gelangmurah	ゲルマンミュラー
jeban	ジェファン
eve	イブ
bwstyles_gf	bwstyles_gf
carabobo	カラボボ
superhubs	スーパーハブ
once	一度
tattooshop	タトゥーショー
hardwell	ハードウェル
инстаграм	инстаграм
gingercat	ギング
bichon	ビション
rumba	ルンバ
okay	はい
astrology	占星術
spamme	スパンメ
stayathomemom	stayathomemom
cansada	カンザス
olive	オリーブ
opening	開ける
brooch	ブローチ
likesplease	好き嫌い
picsoftheday	一日の写真
watercolorpainting	水彩画
fiji	フィジー
柴犬	柴犬
senada	セナダ
emmawatson	エマ・ワトソン
juntos	ジャント
scream	悲鳴
sneakpeek	スニークピーク
lovehersomuch	愛する者たち
contests	コンテスト
cavalier	無邪気な
missouri	ミズーリ州
primal	プライマル
shabby	手のひら
familyiseverything	家族はすべてだ
leatherjacket	レザージャケット
maga	マガ
mondaymood	月曜日
jasper	碧玉
muscat	マスカット
camel	キャメル
nostalgic	ノスタルジックな
plannergirl	plannergirl
knitwear	ニット
нск	нск
dna	DNA
fallow	休閑
sterlingsilver	スターリングシルバー
instanice	インストラクター
urbanoutfitters	urbanoutfitters
enamorada	エナモラダ
popularphoto	人気のある写真
anonovo	anonovo
kc	kc
satan	サタン
kot	コット
newalbum	新しいアルバム
mars	火星
powerbank	パワー・バンク
mais	トウモロコシ
chilly	肌寒い
tap	タップ
チワワ	チワ
chowchow	チャウチョウ
oldtimes	昔の
lookbookindonesia	lookbookindonesia
aura	オーラ
instagoods	instagoods
tardis	鎮痛
vscocamgram	vscocamgram
sonic	音波
caribe	カリブ
holyspirit	聖霊
fashionlove	ファッションローブ
catchup	追いつく
jisoo	ジスー
termurah	トンデュラ
rt	RT
duramax	デュラマックス
kitapkurdu	Kitapkurdu
photo_turkey	photo_turkey
hitler	ヒッラー
yogadaily	ヨーガデイリー
notte	ノート
carnaval2017	カーネバル2017
sabadao	サバダオ
rsa_bnw	rsa_bnw
tacoma	タコマ
freddo	フレッド
lotion	ローション
partyplanner	パーティープランナー
upallnight	徹夜する
airbnb	エアバッグ
krispykreme	クリスピークリーム
sepatupria	セパプリア
streetartistry	ストリートアート
inkstagram	インクシェイム
popup	現れる
kurdistan	クルド人
karachi	カラチ
instaview	インスタレーション
redwhiteandblue	赤色、白色、そして青色
春	春
artbasel	アートバス
swift	迅速
ferriswheel	観覧車
bestfriendgoals	ベストフレンドゴール
passport	パスポート
java	ジャワ
幸せ	幸せ
filme	映画
bershka	ベルシュカ
preorderusa	事前注文
cakedesign	ケーキデザイン
bomdiaa	ボムディアア
bieberfever	ビーバーフィーバー
makanan	マカナン
instaguy	インストラクション
canarias	カナリアス
rhodeisland	ロードアイランド
san	サン
crochetlove	かぎ針編み
r8	r8
thedailykitten	thedailykitten
like4follower	like4follower
californiaadventure	californiaadventure
skrillex	スケリック
петербург	петербург
vca	vca
askingalexandria	アレキサンドラに聞いてるところ
